dbid,subject,experiment,session,condition,lm_scenarios,tm_scenarios,ls_n,lt_n,ts_n,tt_n,d_n,ls_t,lt_t,ts_t,tt_t,d_t,d_t_2,linear_time,triangular_time,draw_time,totalTime,LM_T_M,TM_T_M,DT_T_M,TOTAL_T_M,DIFF_T_M,linear_score,triangular_score,score_diff,time_diff,totalScore,AGE,COUNTRY,LANGUAGE,EDUCATION,MAJOR,GENDER,PREFERENCE,FLAG
58e45f84d46cc6fa347eac15,1TOKK,experiment,alfa,2,axis,longmire,4,7,3,6,1,323944,467263,169672,693145,26595,874527,791207,862817,901122,2921084,13.19,14.38,15.02,48.68,-1.19,11,9,-2,-71610,21,19,India,English,First,Social Sciences (incl. CogSci),Male,the first one (linear,
58e45f84d46cc6fa347eac16,TMBDE,reverse,alfa,0,axis,longmire,4,5,2,3,1,170610,458183,167828,816211,193835,606465,628793,984039,800300,2717972,10.48,16.40,13.34,45.30,-5.92,9,5,-4,-355246,15,21,USA,English,Fourth,Natural Sciences,Female,the second one (triangular),
58e45f84d46cc6fa347eac17,FTSL1,experiment,alfa,0,longmire,axis,4,8,1,0,2,151691,394924,312031,401353,153277,820621,546615,713384,973898,2452276,9.11,11.89,16.23,40.87,-2.78,12,1,-11,-166769,15,18,USA,English,First,Social Sciences (incl. CogSci),Female,the first one (linear,
58e45f84d46cc6fa347eac18,UVPNA,reverse,alfa,3,axis,longmire,4,5,4,8,2,143134,315774,267617,721501,622975,147532,458908,989118,770507,2748243,7.65,16.49,12.84,45.80,-8.84,9,12,3,-530210,23,20,Mexico ,Spanish,Third,Natural Sciences,Female,the second one (triangular),
58e45f84d46cc6fa347eac19,YHU8T,experiment,alfa,0,axis,longmire,5,4,3,4,0,189577,396414,205147,637973,165923,566650,585991,843120,732573,2530148,9.77,14.05,12.21,42.17,-4.29,9,7,-2,-257129,16,23,Korea,Other,Third,Social Sciences (incl. CogSci),Male,the first one (linear,
58e45f84d46cc6fa347eac1a,67JMM,experiment,alfa,0,longmire,axis,5,6,3,8,2,158318,497265,485284,337582,265082,457078,655583,822866,722160,2454470,10.93,13.71,12.04,40.91,-2.79,11,11,0,-167283,24,18,USA,English,First,Natural Sciences,Male,the first one (linear,
58e45f84d46cc6fa347eac1b,WFQJK,experiment,alfa,3,axis,longmire,5,9,4,9,1,175697,282442,116223,319138,140347,678491,458139,435361,818838,2011141,7.64,7.26,13.65,33.52,0.38,14,13,-1,22778,28,22,China,Mandarin or Cantonese,Fourth,Social Sciences (incl. CogSci),Male,the second one (triangular),
58e45f84d46cc6fa347eac1c,CK7VW,reverse,alfa,3,longmire,axis,4,6,3,6,1,100247,479098,341516,417999,54019,631007,579345,759515,685026,2310484,9.66,12.66,11.42,38.51,-3.00,10,9,-1,-180170,20,20,USA,Other,Third,Social Sciences (incl. CogSci),Female,the first one (linear,
58e45f84d46cc6fa347eac1d,S9XA4,reverse,alfa,0,longmire,axis,3,6,0,0,0,197036,444313,387568,662236,83048,1089972,641349,1049804,1173020,3005025,10.69,17.50,19.55,50.08,-6.81,9,0,-9,-408455,9,22,USA,English,Fourth,Social Sciences (incl. CogSci),Male,the first one (linear,
58e45f84d46cc6fa347eac1e,RKCHG,reverse,alfa,0,longmire,axis,4,4,1,0,1,94000,393301,298793,379629,472570,313279,487301,678422,785849,2233627,8.12,11.31,13.10,37.23,-3.19,8,1,-7,-191121,10,20,USA,English,Third,Social Sciences (incl. CogSci),Female,the first one (linear,
58e45f84d46cc6fa347eac20,565WH,reverse,alfa,3,axis,longmire,5,8,4,8,2,122156,250259,147557,384736,99037,535211,372415,532293,634248,1817125,6.21,8.87,10.57,30.29,-2.66,13,12,-1,-159878,27,21,USA,English,Fourth,Biomedical & Health Sciences,Female,the second one (triangular),
58e45f84d46cc6fa347eac21,Y6F1V,experiment,alfa,0,longmire,axis,4,6,1,0,2,79735,237591,68301,171237,701025,53103,317326,239538,754128,1508756,5.29,3.99,12.57,25.15,1.30,10,1,-9,77788,13,24,USA,English,Fifth,Social Sciences (incl. CogSci),Female,the first one (linear,
58e45f84d46cc6fa347eac22,1TL49,reverse,alfa,0,axis,longmire,3,5,3,2,0,90724,223627,73739,291109,100545,349132,314351,364848,449677,1352540,5.24,6.08,7.49,22.54,-0.84,8,5,-3,-50497,13,19,USA,English,Second,Social Sciences (incl. CogSci),Female,the first one (linear,
58e45f84d46cc6fa347eac23,K4PCN,experiment,alfa,3,axis,longmire,5,8,4,10,2,150219,300856,160929,422574,288012,741116,451075,583503,1029128,2815590,7.52,9.73,17.15,46.93,-2.21,13,14,1,-132428,29,21,China,Mandarin or Cantonese,Third,Math or Computer Sciences,Female,the first one (linear,
58e45f84d46cc6fa347eac24,S7D7C,reverse,alfa,0,axis,longmire,4,6,5,9,1,77523,263854,95830,245327,419969,379690,341377,341157,799659,1811499,5.69,5.69,13.33,30.19,0.00,10,14,4,220,25,21,USA,English,Fourth,Social Sciences (incl. CogSci),Female,the first one (linear,
58e45f84d46cc6fa347eac25,RGU59,reverse,alfa,0,axis,longmire,5,8,4,8,2,129529,380276,221921,321893,88726,668534,509805,543814,757260,2119895,8.50,9.06,12.62,35.33,-0.57,13,12,-1,-34009,27,18,USA,English,First,Social Sciences (incl. CogSci),Female,the first one (linear,
58e45f84d46cc6fa347eac26,WCPQA,reverse,alfa,0,axis,longmire,5,8,2,4,1,100127,184859,185634,587097,36961,413586,284986,772731,450547,1782457,4.75,12.88,7.51,29.71,-8.13,13,6,-7,-487745,20,20,USA,Other,Third,Biomedical & Health Sciences,Female,the first one (linear,
58e45f84d46cc6fa347eac27,HF8PP,experiment,alfa,2,longmire,axis,3,8,3,9,2,63703,286471,164220,215431,120791,372105,350174,379651,492896,1436835,5.84,6.33,8.21,23.95,-0.49,11,12,1,-29477,25,20,USA,English,Third,Math or Computer Sciences,Male,the second one (triangular),
58e45f84d46cc6fa347eac28,E8DLP,experiment,alfa,3,longmire,axis,2,3,3,3,0,85259,241746,143879,179775,206197,146521,327005,323654,352718,1321572,5.45,5.39,5.88,22.03,0.06,5,6,1,3351,11,19,TURKEY,Other,First,Natural Sciences,Female,the first one (linear,
58e45f47d46cc6fa347ea5d2,0UUFC,experiment,bravo,3,longmire,axis,4,5,2,6,1,133750,894922,242399,458259,135794,883766,1028672,700658,1019560,3059086,17.14,11.68,16.99,50.98,5.47,9,8,-1,328014,18,19,USA,English,Second,Social Sciences (incl. CogSci),Female,the first one (linear,
58e45f47d46cc6fa347ea5d4,ZNUEO,experiment,bravo,2,axis,longmire,5,8,5,9,2,232809,383135,268736,479839,203246,608330,615944,748575,811576,2515649,10.27,12.48,13.53,41.93,-2.21,13,14,1,-132631,29,22,USA,English,Fifth,Natural Sciences,Male,the first one (linear,
58e45f47d46cc6fa347ea5d5,5ZV2X,experiment,bravo,2,axis,longmire,3,7,2,5,2,244860,321167,253429,370941,113733,726536,566027,624370,840269,2492380,9.43,10.41,14.00,41.54,-0.97,10,7,-3,-58343,19,20,USA,Spanish,Third,Biomedical & Health Sciences,Female,the second one (triangular),
58e45f47d46cc6fa347ea5d6,1129F,experiment,bravo,3,axis,longmire,2,2,3,2,2,136471,117408,125942,224296,86567,326123,253879,350238,412690,1528455,4.23,5.84,6.88,25.47,-1.61,4,5,1,-96359,11,21,China,English,Fourth,Biomedical & Health Sciences,Female,the first one (linear,
58e45f47d46cc6fa347ea5d9,JYJXS,reverse,bravo,2,axis,longmire,4,9,5,10,2,126575,328198,153803,358266,77358,837294,454773,512069,914652,2223070,7.58,8.53,15.24,37.05,-0.95,13,15,2,-57296,30,22,USA,Other,Third,Biomedical & Health Sciences,Female,the second one (triangular),
58e45f47d46cc6fa347ea5da,76WFU,reverse,bravo,3,axis,longmire,4,7,2,7,1,167692,405082,114181,509789,268064,771629,572774,623970,1039693,2609087,9.55,10.40,17.33,43.48,-0.85,11,9,-2,-51196,21,24,USA,English,Fourth,Social Sciences (incl. CogSci),Female,the first one (linear,
58e45f47d46cc6fa347ea5db,N5CZB,reverse,bravo,2,longmire,axis,5,8,3,7,1,135563,268022,342299,401234,144809,532121,403585,743533,676930,2508585,6.73,12.39,11.28,41.81,-5.67,13,10,-3,-339948,24,21,China,Mandarin or Cantonese,Third,Social Sciences (incl. CogSci),Male,the first one (linear,
58e45f47d46cc6fa347ea5dc,FSJAY,reverse,bravo,2,axis,longmire,5,8,4,7,2,174007,467129,261624,581978,207667,735438,641136,843602,943105,3082170,10.69,14.06,15.72,51.37,-3.37,13,11,-2,-202466,26,22,USA,English,Fourth,Math or Computer Sciences,Male,the first one (linear,
58e45f47d46cc6fa347ea5de,A5G40,experiment,bravo,2,longmire,axis,4,4,1,0,0,125323,424809,145575,164426,23756,468314,550132,310001,492070,1732827,9.17,5.17,8.20,28.88,4.00,8,1,-7,240131,9,21,China,Mandarin or Cantonese,Fourth,Social Sciences (incl. CogSci),Male,the first one (linear,
58e45f47d46cc6fa347ea5df,9T9QO,experiment,bravo,2,longmire,axis,3,7,3,8,2,128517,433704,179384,323797,117300,889754,562221,503181,1007054,2356673,9.37,8.39,16.78,39.28,0.98,10,11,1,59040,23,21,USA,English,Fourth,Social Sciences (incl. CogSci),Female,the first one (linear,
58e45f47d46cc6fa347ea5e1,CHZCL,reverse,bravo,2,axis,longmire,5,6,5,5,1,150918,320738,203809,527189,185422,979986,471656,730998,1165408,2660271,7.86,12.18,19.42,44.34,-4.32,11,10,-1,-259342,22,18,USA,English,First,Biomedical & Health Sciences,Female,the first one (linear,
58e45f47d46cc6fa347ea5e2,AUN52,experiment,bravo,3,axis,longmire,4,5,5,8,2,132471,364354,177567,281978,84654,591395,496825,459545,676049,1923215,8.28,7.66,11.27,32.05,0.62,9,13,4,37280,24,21,China,Mandarin or Cantonese,Fourth,Social Sciences (incl. CogSci),Female,the first one (linear,
58e45f47d46cc6fa347ea5e3,Q3HE8,reverse,bravo,0,longmire,axis,5,9,2,7,1,122060,387635,400212,675529,109302,740048,509695,1075741,849350,2849603,8.49,17.93,14.16,47.49,-9.43,14,9,-5,-566046,24,22,China,Mandarin or Cantonese,Fourth,Biomedical & Health Sciences,Female,the first one (linear,
58e45f47d46cc6fa347ea5e5,TGAU4,experiment,bravo,0,longmire,axis,3,7,1,0,1,129790,601412,255442,336158,166200,542180,731202,591600,708380,2328840,12.19,9.86,11.81,38.81,2.33,10,1,-9,139602,12,21,USA,Spanish,Fourth,Math or Computer Sciences,Female,the first one (linear,
58e45f47d46cc6fa347ea5e6,Y7TQD,reverse,bravo,3,longmire,axis,3,4,3,5,0,111740,382926,196377,323742,59206,503196,494666,520119,562402,1813759,8.24,8.67,9.37,30.23,-0.42,7,8,1,-25453,15,19,USA,English,Third,Biomedical & Health Sciences,Female,the second one (triangular),
58e45f47d46cc6fa347ea5e8,WYGTA,reverse,bravo,3,longmire,axis,4,8,2,5,1,144126,360669,164853,316564,519001,131484,504795,481417,650485,2033550,8.41,8.02,10.84,33.89,0.39,12,7,-5,23378,20,21,USA,English,Third,Social Sciences (incl. CogSci),Female,the first one (linear,
58e45f47d46cc6fa347ea5e9,1592P,reverse,bravo,2,axis,longmire,5,9,4,7,1,132153,289693,237219,405558,312313,789486,421846,642777,1101799,2458631,7.03,10.71,18.36,40.98,-3.68,14,11,-3,-220931,26,19,China,Mandarin or Cantonese,First,Math or Computer Sciences,Female,the second one (triangular),
58e45eadd46cc6fa347e9e59,1ENZF,experiment,charlie,3,longmire,axis,4,9,0,5,1,145373,416336,305176,269125,182103,577811,561709,574301,759914,2432776,9.36,9.57,12.67,40.55,-0.21,13,5,-8,-12592,19,21,USA,Mandarin or Cantonese,Fourth,Biomedical & Health Sciences,Female,the first one (linear,
58e45eadd46cc6fa347e9e5a,UKKNJ,reverse,charlie,0,longmire,axis,5,8,1,7,1,113678,399418,313667,431244,505476,42392,513096,744911,547868,2329340,8.55,12.42,9.13,38.82,-3.86,13,8,-5,-231815,22,19,USA,English,Second,Social Sciences (incl. CogSci),Male,the first one (linear,
58e45eadd46cc6fa347e9e5f,WUQMM,reverse,charlie,2,axis,longmire,5,6,3,9,2,145342,312988,335384,348567,77259,817617,458330,683951,894876,2593594,7.64,11.40,14.91,43.23,-3.76,11,12,1,-225621,25,20,Sri Lanka,English,Third,Biomedical & Health Sciences,Female,the second one (triangular),
58e45eadd46cc6fa347e9e60,OZWVZ,reverse,charlie,3,longmire,axis,5,5,0,1,1,119206,307767,307842,462330,126074,423877,426973,770172,549951,2307572,7.12,12.84,9.17,38.46,-5.72,10,1,-9,-343199,12,30,Korea,Other,Fourth,Fine Arts,Male,the second one (triangular),
58e45eadd46cc6fa347e9e61,DZ413,reverse,charlie,2,axis,longmire,3,6,2,1,1,229865,298062,168153,754817,87280,527171,527927,922970,614451,2806047,8.80,15.38,10.24,46.77,-6.58,9,3,-6,-395043,13,19,USA,English,Second,Biomedical & Health Sciences,Female,the first one (linear,
58e45eadd46cc6fa347e9e62,8UFM6,reverse,charlie,0,longmire,axis,4,7,3,3,1,98072,465366,225307,282869,513921,247170,563438,508176,761091,2244545,9.39,8.47,12.68,37.41,0.92,11,6,-5,55262,18,20,China,Mandarin or Cantonese,Second,Social Sciences (incl. CogSci),Female,the first one (linear,
58e45eadd46cc6fa347e9e63,T8OEA,reverse,charlie,0,longmire,axis,3,6,1,1,0,126349,472693,215449,500517,14592,963379,599042,715966,977971,2771793,9.98,11.93,16.30,46.20,-1.95,9,2,-7,-116924,11,24,USA,Spanish,Third,Social Sciences (incl. CogSci),Male,the first one (linear,
58e45eadd46cc6fa347e9e64,GEDKA,reverse,charlie,3,longmire,axis,4,9,3,9,2,130543,344149,124534,302877,662790,88748,474692,427411,751538,2185466,7.91,7.12,12.53,36.42,0.79,13,12,-1,47281,27,20,China,Mandarin or Cantonese,Second,Social Sciences (incl. CogSci),Male,the first one (linear,
58e45eadd46cc6fa347e9e66,E1YEU,experiment,charlie,3,longmire,axis,4,4,0,4,0,151244,459893,226316,328928,521230,193388,611137,555244,714618,2341864,10.19,9.25,11.91,39.03,0.93,8,4,-4,55893,12,17,USA,English,Second,Biomedical & Health Sciences,Female,the first one (linear,
58e45eadd46cc6fa347e9e67,MMVNP,reverse,charlie,3,longmire,axis,3,4,0,1,0,111759,365167,236672,407354,109830,516442,476926,644026,626272,2220700,7.95,10.73,10.44,37.01,-2.79,7,1,-6,-167100,8,19,Korea,Other,First,Social Sciences (incl. CogSci),Male,the first one (linear,
58e45eadd46cc6fa347e9e68,6T9O9,experiment,charlie,2,longmire,axis,5,8,3,9,2,103450,385941,214890,241539,76750,500211,489391,456429,576961,1983076,8.16,7.61,9.62,33.05,0.55,13,12,-1,32962,27,18,USA,Other,First,Biomedical & Health Sciences,Female,the first one (linear,
58e45eadd46cc6fa347e9e69,WKKMG,experiment,charlie,2,longmire,axis,4,8,1,0,1,135190,370858,182948,371731,224342,375129,506048,554679,599471,2166739,8.43,9.24,9.99,36.11,-0.81,12,1,-11,-48631,14,21,USA,English,Third,Math or Computer Sciences,Female,the first one (linear,
58e45eadd46cc6fa347e9e6a,X309N,experiment,charlie,3,longmire,axis,4,7,5,10,1,145449,712987,204583,396216,221723,629081,858436,600799,850804,2735413,14.31,10.01,14.18,45.59,4.29,11,15,4,257637,27,18,USA,English,First,Fine Arts,Female,the second one (triangular),
58e45eadd46cc6fa347e9e6b,QEHR1,reverse,charlie,2,longmire,axis,4,4,1,4,2,96103,418957,233817,349219,102199,348020,515060,583036,450219,2041610,8.58,9.72,7.50,34.03,-1.13,8,5,-3,-67976,15,18,USA,English,First,Social Sciences (incl. CogSci),Female,the first one (linear,
58e45eadd46cc6fa347e9e6c,B7CJ3,reverse,charlie,3,longmire,axis,4,4,1,0,0,107634,321124,121967,347333,72450,765484,428758,469300,837934,2230762,7.15,7.82,13.97,37.18,-0.68,8,1,-7,-40542,9,22,Philippines,Other,Fourth,Social Sciences (incl. CogSci),Female,the second one (triangular),
58e45eadd46cc6fa347e9e6d,UWWFF,experiment,charlie,0,longmire,axis,3,4,4,6,2,119121,275488,141251,176318,101999,574094,394609,317569,676093,1756500,6.58,5.29,11.27,29.28,1.28,7,10,3,77040,19,23,China,Mandarin or Cantonese,Fourth,Natural Sciences,Female,the second one (triangular),
58e45e88d46cc6fa347e9790,1Y39Q,experiment,delta,2,axis,longmire,4,7,3,4,0,208871,537416,267185,430510,655200,228909,746287,697695,884109,3139682,12.44,11.63,14.74,52.33,0.81,11,7,-4,48592,18,29,China,Mandarin or Cantonese,Fifth,Social Sciences (incl. CogSci),Female,the second one (triangular),
58e45e88d46cc6fa347e9791,OQWZ1,reverse,delta,0,longmire,axis,4,8,2,7,1,129068,319840,240325,373193,242485,920960,448908,613518,1163445,2473946,7.48,10.23,19.39,41.23,-2.74,12,9,-3,-164610,22,22,China,Mandarin or Cantonese,Third,Math or Computer Sciences,Male,the first one (linear,
58e45e88d46cc6fa347e9792,X3K4N,reverse,delta,2,longmire,axis,4,5,1,0,0,147944,609497,196689,516331,567030,68424,757441,713020,635454,3314636,12.62,11.88,10.59,55.24,0.74,9,1,-8,44421,10,19,USA,English,Second,Humanities,Female,the first one (linear,
58e45e88d46cc6fa347e9793,BAC71,reverse,delta,3,longmire,axis,4,8,1,0,1,139603,398438,230466,471089,156602,608369,538041,701555,764971,2749690,8.97,11.69,12.75,45.83,-2.73,12,1,-11,-163514,14,20,USA,English,Third,Social Sciences (incl. CogSci),Female,the second one (triangular),
58e45e88d46cc6fa347e9794,192S2,reverse,delta,3,axis,longmire,4,7,2,0,2,165661,237170,120771,445369,113303,857402,402831,566140,970705,2808931,6.71,9.44,16.18,46.82,-2.72,11,2,-9,-163309,15,20,USA,Spanish,Third,Social Sciences (incl. CogSci),Female,the first one (linear,
58e45e88d46cc6fa347e9796,JE4L8,experiment,delta,3,longmire,axis,4,9,4,9,2,93738,335385,149287,318924,80029,771143,429123,468211,851172,2082716,7.15,7.80,14.19,34.71,-0.65,13,13,0,-39088,28,22,Australia,Mandarin or Cantonese,Fifth,Social Sciences (incl. CogSci),Male,the second one (triangular),
58e45e88d46cc6fa347e9797,DRWFW,experiment,delta,3,axis,longmire,5,10,4,10,2,180947,393374,111402,325970,94795,512361,574321,437372,607156,2714978,9.57,7.29,10.12,45.25,2.28,15,14,-1,136949,31,20,Brazil,Other,Third,Engineering,Female,the second one (triangular),
58e45e88d46cc6fa347e9798,93LO6,reverse,delta,2,longmire,axis,5,7,1,8,1,197664,459081,453364,379191,465736,532799,656745,832555,998535,3221835,10.95,13.88,16.64,53.70,-2.93,12,9,-3,-175810,22,18,USA,English,First,Humanities,Female,the first one (linear,
58e45e88d46cc6fa347e979a,WA9MH,reverse,delta,2,axis,longmire,4,8,2,1,1,128381,261839,219049,595603,94214,984765,390220,814652,1078979,3016830,6.50,13.58,17.98,50.28,-7.07,12,3,-9,-424432,16,20,USA,English,Second,Social Sciences (incl. CogSci),Female,the first one (linear,
58e45e88d46cc6fa347e979b,JO52X,reverse,delta,0,longmire,axis,4,5,1,0,2,93441,462925,325352,454494,113131,755693,556366,779846,868824,3066958,9.27,13.00,14.48,51.12,-3.72,9,1,-8,-223480,12,18,Canada,English,First,Social Sciences (incl. CogSci),Female,the first one (linear,
58e45e88d46cc6fa347e979c,GJP2D,experiment,delta,3,axis,longmire,4,4,1,1,0,309409,536683,129044,535535,57978,460773,846092,664579,518751,2506073,14.10,11.08,8.65,41.77,3.03,8,2,-6,181513,10,20,USA,English,Third,Biomedical & Health Sciences,Male,the first one (linear,
58e45e88d46cc6fa347e979d,MW095,reverse,delta,2,axis,longmire,4,2,1,2,0,194559,238516,188112,432841,76154,466621,433075,620953,542775,2732614,7.22,10.35,9.05,45.54,-3.13,6,3,-3,-187878,9,19,USA,English,First,Biomedical & Health Sciences,Female,the first one (linear,
58e45e88d46cc6fa347e979f,6Z2EO,experiment,delta,2,axis,longmire,3,10,5,8,2,110387,239294,130042,276652,75304,626039,349681,406694,701343,2146217,5.83,6.78,11.69,35.77,-0.95,13,13,0,-57013,28,19,USA,English,Second,Natural Sciences,Female,the second one (triangular),
58e45e88d46cc6fa347e97a0,JL0XP,reverse,delta,3,axis,longmire,5,7,4,9,1,115724,251237,132758,352473,88712,615416,366961,485231,704128,2371378,6.12,8.09,11.74,39.52,-1.97,12,13,1,-118270,26,18,China,Mandarin or Cantonese,First,Social Sciences (incl. CogSci),Female,the second one (triangular),
58e45e88d46cc6fa347e97a4,JCSDC,reverse,delta,3,axis,longmire,5,9,4,6,2,165409,300362,200037,636709,472260,960435,465771,836746,1432695,3259571,7.76,13.95,23.88,54.33,-6.18,14,10,-4,-370975,26,19,USA,English,Second,Engineering,Male,the first one (linear,
58e45e88d46cc6fa347e97a5,9MGOB,reverse,delta,2,longmire,axis,5,7,2,7,1,167727,453144,296409,349969,126848,1165675,620871,646378,1292523,3860306,10.35,10.77,21.54,64.34,-0.43,12,9,-3,-25507,22,21,USA,English,Third,Social Sciences (incl. CogSci),Female,the first one (linear,
58e45e88d46cc6fa347e97a6,ZP8OY,experiment,delta,0,longmire,axis,4,6,1,0,1,150376,432118,267235,370044,142746,553329,582494,637279,696075,2457217,9.71,10.62,11.60,40.95,-0.91,10,1,-9,-54785,12,22,Iraq,Other,Third,Biomedical & Health Sciences,Male,the first one (linear,
58e45e33d46cc6fa347e9060,TA2L5,reverse,echo,3,longmire,axis,4,5,3,5,1,108664,428249,221475,424155,899807,106994,536913,645630,1006801,2385396,8.95,10.76,16.78,39.76,-1.81,9,8,-1,-108717,18,21,USA,English,Fourth,Social Sciences (incl. CogSci),Male,the first one (linear,
58e45e33d46cc6fa347e9061,UOBPQ,reverse,echo,3,longmire,axis,4,6,1,1,0,108371,428223,166751,506336,104932,872878,536594,673087,977810,2377342,8.94,11.22,16.30,39.62,-2.27,10,2,-8,-136493,12,24,mEXICO,Spanish,Fifth,Natural Sciences,Female,the first one (linear,
58e45e33d46cc6fa347e9062,POQNH,reverse,echo,0,longmire,axis,4,8,1,5,2,132110,407387,258584,518476,147056,622498,539497,777060,769554,2239647,8.99,12.95,12.83,37.33,-3.96,12,6,-6,-237563,20,21,USA,Other,Fourth,Social Sciences (incl. CogSci),Female,the first one (linear,
58e45e33d46cc6fa347e9063,W12ZU,reverse,echo,2,axis,longmire,4,3,2,2,1,163910,356553,337470,603253,597115,118215,520463,940723,715330,2363125,8.67,15.68,11.92,39.39,-7.00,7,4,-3,-420260,12,21,USA,English,Fourth,Biomedical & Health Sciences,Female,the first one (linear,
58e45e33d46cc6fa347e9064,FTX1J,reverse,echo,2,longmire,axis,5,6,1,0,1,139084,446429,176348,379811,364934,642988,585513,556159,1007922,2340290,9.76,9.27,16.80,39.00,0.49,11,1,-10,29354,13,21,China,Mandarin or Cantonese,Fourth,Social Sciences (incl. CogSci),Female,the second one (triangular),
58e45e33d46cc6fa347e9065,UUTZ9,reverse,echo,3,axis,longmire,4,9,5,8,2,161088,321633,140279,411771,156240,765612,482721,552050,921852,2223797,8.05,9.20,15.36,37.06,-1.16,13,13,0,-69329,28,18,USA,Mandarin or Cantonese,First,Engineering,Male,the second one (triangular),
58e45e33d46cc6fa347e9066,AYPYF,reverse,echo,4,longmire,axis,4,5,1,0,1,137955,358705,405651,598965,165208,626354,496660,1004616,791562,2502554,8.28,16.74,13.19,41.71,-8.47,9,1,-8,-507956,11,20,USA,English,Second,Math or Computer Sciences,Male,the first one (linear,
58e45e33d46cc6fa347e9067,UNUPL,reverse,echo,2,axis,longmire,4,8,1,5,2,107661,287586,215480,671074,104298,610540,395247,886554,714838,2203064,6.59,14.78,11.91,36.72,-8.19,12,6,-6,-491307,20,20,Taiwan,Mandarin or Cantonese,Second,Biomedical & Health Sciences,Male,the first one (linear,
58e45e33d46cc6fa347e9068,RGOP0,reverse,echo,0,longmire,axis,5,7,4,8,2,114668,415326,216733,328340,636496,152369,529994,545073,788865,2113749,8.83,9.08,13.15,35.23,-0.25,12,12,0,-15079,26,19,USA,English,First,Engineering,Female,the second one (triangular),
58e45e33d46cc6fa347e9069,78CYG,reverse,echo,3,longmire,axis,4,7,4,6,2,106617,308157,131163,392302,130290,884390,414774,523465,1014680,2127691,6.91,8.72,16.91,35.46,-1.81,11,10,-1,-108691,23,19,USA,English,Second,Social Sciences (incl. CogSci),Female,the first one (linear,
58e45e33d46cc6fa347e906a,WMNAY,experiment,echo,4,axis,longmire,3,5,4,7,2,159028,331220,134985,443985,566574,104189,490248,578970,670763,1946437,8.17,9.65,11.18,32.44,-1.48,8,11,3,-88722,21,22,China,Mandarin or Cantonese,First,Social Sciences (incl. CogSci),Female,the second one (triangular),
58e45e33d46cc6fa347e906b,2JSK2,experiment,echo,2,axis,longmire,4,9,4,10,2,141790,494496,186568,363475,128028,561211,636286,550043,689239,2564704,10.60,9.17,11.49,42.75,1.44,13,14,1,86243,29,20,Brazil,Other,Third,Math or Computer Sciences,Male,the second one (triangular),
58e45e33d46cc6fa347e906c,Z65A1,reverse,echo,4,axis,longmire,4,5,3,8,1,144957,313118,129106,461287,115309,621860,458075,590393,737169,2045305,7.63,9.84,12.29,34.09,-2.21,9,11,2,-132318,21,20,USA,Other,Third,Social Sciences (incl. CogSci),Female,the second one (triangular),
58e45e33d46cc6fa347e906d,WM4OX,reverse,echo,4,longmire,axis,5,8,1,0,2,98111,344385,325172,411145,112472,516238,442496,736317,628710,2050708,7.37,12.27,10.48,34.18,-4.90,13,1,-12,-293821,16,20,USA,English,Second,Social Sciences (incl. CogSci),Male,the first one (linear,
58e45e33d46cc6fa347e906e,9YM1Z,reverse,echo,4,longmire,axis,4,3,0,3,0,93422,338099,112987,161733,835691,75820,431521,274720,911511,1740197,7.19,4.58,15.19,29.00,2.61,7,3,-4,156801,10,21,USA,English,Fourth,Biomedical & Health Sciences,Female,the first one (linear,
58e45e33d46cc6fa347e906f,OOSCB,reverse,echo,3,longmire,axis,5,5,2,4,0,136358,353993,379281,446215,102961,322544,490351,825496,425505,1889229,8.17,13.76,7.09,31.49,-5.59,10,6,-4,-335145,16,21,USA,English,Fourth,Social Sciences (incl. CogSci),Female,the first one (linear,
58e45e33d46cc6fa347e9070,0T69Q,reverse,echo,2,longmire,axis,4,4,2,0,1,116934,472023,276084,273019,694101,41730,588957,549103,735831,2017643,9.82,9.15,12.26,33.63,0.66,8,2,-6,39854,11,19,Korea,Other,First,Math or Computer Sciences,Male,the first one (linear,
58e45e33d46cc6fa347e9071,0O5R5,reverse,echo,2,axis,longmire,5,10,5,7,1,132647,271115,240896,432616,115521,1257100,403762,673512,1372621,2963956,6.73,11.23,22.88,49.40,-4.50,15,12,-3,-269750,28,18,USA,English,First,Social Sciences (incl. CogSci),Female,the first one (linear,
58e45e33d46cc6fa347e9072,1SZED,reverse,echo,2,longmire,axis,4,9,2,8,1,91464,296172,263062,222281,179377,563217,387636,485343,742594,1847544,6.46,8.09,12.38,30.79,-1.63,13,10,-3,-97707,24,21,USA,English,Third,Social Sciences (incl. CogSci),Male,the first one (linear,
58e45e33d46cc6fa347e9073,RE9Z1,experiment,echo,0,axis,longmire,5,6,3,3,1,175448,229328,193595,374587,54284,492279,404776,568182,546563,1860234,6.75,9.47,9.11,31.00,-2.72,11,6,-5,-163406,18,18,USA,English,First,Humanities,Female,the first one (linear,
58e45e33d46cc6fa347e9074,DJ7X4,experiment,echo,2,longmire,axis,3,6,1,0,0,156949,377362,244968,331777,70638,442445,534311,576745,513083,1859069,8.91,9.61,8.55,30.98,-0.71,9,1,-8,-42434,10,21,USA,English,Third,Social Sciences (incl. CogSci),Male,the first one (linear,
58e45e33d46cc6fa347e9075,26O5W,reverse,echo,3,longmire,axis,5,9,3,8,2,104292,336780,226991,385746,111113,678750,441072,612737,789863,2066367,7.35,10.21,13.16,34.44,-2.86,14,11,-3,-171665,27,23,Korea,Other,Third,Social Sciences (incl. CogSci),Female,the first one (linear,
58e45e33d46cc6fa347e9076,AX24A,reverse,echo,4,longmire,axis,5,5,1,1,2,101902,270685,160133,344181,101721,464301,372587,504314,566022,1564066,6.21,8.41,9.43,26.07,-2.20,10,2,-8,-131727,14,21,USA,English,Fourth,Biomedical & Health Sciences,Female,the first one (linear,
58e45e33d46cc6fa347e9077,KV969,reverse,echo,2,axis,longmire,5,7,4,6,1,117935,240414,152513,319784,150721,355404,358349,472297,506125,1511963,5.97,7.87,8.44,25.20,-1.90,12,10,-2,-113948,23,22,USA,English,Fifth,Social Sciences (incl. CogSci),Female,the first one (linear,
58e45df9d46cc6fa347e88f1,QP34G,reverse,foxtrot,2,axis,longmire,5,4,5,8,1,199882,577400,188808,542450,285286,949852,777282,731258,1235138,2956385,12.95,12.19,20.59,49.27,0.77,9,13,4,46024,23,20,INDONESIA,Other,Fourth,Social Sciences (incl. CogSci),Female,the second one (triangular),
58e45df9d46cc6fa347e88f2,NRVM6,experiment,foxtrot,2,longmire,axis,3,7,0,9,2,222758,621305,373252,360655,180922,751329,844063,733907,932251,2998922,14.07,12.23,15.54,49.98,1.84,10,9,-1,110156,21,19,China,Mandarin or Cantonese,First,Social Sciences (incl. CogSci),Female,the first one (linear,
58e45df9d46cc6fa347e88f3,9CB27,experiment,foxtrot,3,axis,longmire,5,7,5,10,2,214140,481049,173075,388562,299313,1084394,695189,561637,1383707,2865357,11.59,9.36,23.06,47.76,2.23,12,15,3,133552,29,18,Mexico,Spanish,First,Math or Computer Sciences,Male,the first one (linear,
58e45df9d46cc6fa347e88f4,O4HU0,experiment,foxtrot,3,longmire,axis,2,8,1,9,0,149470,816164,274123,453766,1186143,224606,965634,727889,1410749,3753889,16.09,12.13,23.51,62.56,3.96,10,10,0,237745,20,28,Belarus,Other,Third,Math or Computer Sciences,Female,the second one (triangular),
58e45df9d46cc6fa347e88f5,LXM5D,experiment,foxtrot,2,longmire,axis,5,8,4,10,2,157034,625152,175590,354951,166457,860270,782186,530541,1026727,2722568,13.04,8.84,17.11,45.38,4.19,13,14,1,251645,29,19,China,Mandarin or Cantonese,Second,Social Sciences (incl. CogSci),Female,the second one (triangular),
58e45df9d46cc6fa347e88f6,CZLGR,reverse,foxtrot,2,longmire,axis,4,6,5,8,0,87437,419564,302754,340350,196397,966667,507001,643104,1163064,2648298,8.45,10.72,19.38,44.14,-2.27,10,13,3,-136103,23,18,USA,Mandarin or Cantonese,First,Social Sciences (incl. CogSci),Female,the first one (linear,
58e45df9d46cc6fa347e88f7,P3Y2J,experiment,foxtrot,2,axis,longmire,2,7,4,6,2,160366,464145,170828,465702,143233,632121,624511,636530,775354,2346793,10.41,10.61,12.92,39.11,-0.20,9,10,1,-12019,21,18,USA,English,First,Social Sciences (incl. CogSci),Female,the second one (triangular),
58e45df9d46cc6fa347e88f8,FSTGR,experiment,foxtrot,0,longmire,axis,2,5,4,8,0,138908,432540,212666,333309,103747,1235003,571448,545975,1338750,2834703,9.52,9.10,22.31,47.25,0.42,7,12,5,25473,19,18,USA,English,First,Social Sciences (incl. CogSci),Male,the first one (linear,
58e45df9d46cc6fa347e88f9,UPEEJ,reverse,foxtrot,3,axis,longmire,4,7,2,5,2,161793,475703,158667,520995,223830,684386,637496,679662,908216,2469146,10.62,11.33,15.14,41.15,-0.70,11,7,-4,-42166,20,25,USA,English,Third,Social Sciences (incl. CogSci),Female,the second one (triangular),
58e45df9d46cc6fa347e88fa,90L9R,experiment,foxtrot,0,longmire,axis,4,5,1,1,0,185010,454757,329355,371944,58596,1058021,639767,701299,1116617,2787107,10.66,11.69,18.61,46.45,-1.03,9,2,-7,-61532,11,22,USA,English,Fourth,Social Sciences (incl. CogSci),Female,the first one (linear,
58e45df9d46cc6fa347e88fb,5EC34,experiment,foxtrot,3,axis,longmire,5,8,2,9,2,175115,480923,167867,513287,192997,470979,656038,681154,663976,2402300,10.93,11.35,11.07,40.04,-0.42,13,11,-2,-25116,26,21,USA,English,Fourth,Social Sciences (incl. CogSci),Female,the first one (linear,
58e45df9d46cc6fa347e88fc,BZ88S,reverse,foxtrot,0,axis,longmire,4,4,3,6,0,180765,361452,163088,459446,794759,201719,542217,622534,996478,2294960,9.04,10.38,16.61,38.25,-1.34,8,9,1,-80317,17,20,Korea,Other,Third,Social Sciences (incl. CogSci),Female,the first one (linear,
58e45df9d46cc6fa347e88fd,TPMBF,experiment,foxtrot,3,longmire,axis,5,8,5,10,1,149793,440768,187945,374794,110447,757518,590561,562739,867965,2293758,9.84,9.38,14.47,38.23,0.46,13,15,2,27822,29,20,USA,English,Third,Social Sciences (incl. CogSci),Female,the first one (linear,
58e45df9d46cc6fa347e88fe,MJGHF,experiment,foxtrot,2,longmire,axis,4,8,5,9,2,146969,456221,222245,320003,174126,379022,603190,542248,553148,2152293,10.05,9.04,9.22,35.87,1.02,12,14,2,60942,28,21,USA,Other,Fourth,Biomedical & Health Sciences,Male,the second one (triangular),
58e45df9d46cc6fa347e88ff,G1J35,experiment,foxtrot,3,longmire,axis,4,7,5,9,2,85478,436772,163338,317073,488088,134473,522250,480411,622561,1772431,8.70,8.01,10.38,29.54,0.70,11,14,3,41839,27,20,USA,English,Third,Social Sciences (incl. CogSci),Female,the second one (triangular),
58e45df9d46cc6fa347e8900,GLAFZ,experiment,foxtrot,0,longmire,axis,5,7,4,8,0,124722,436649,314353,371009,194184,546082,561371,685362,740266,2150131,9.36,11.42,12.34,35.84,-2.07,12,12,0,-123991,24,21,USA,Spanish,Fourth,Social Sciences (incl. CogSci),Female,the first one (linear,
58e45df9d46cc6fa347e8901,GELJG,experiment,foxtrot,3,longmire,axis,5,6,4,8,2,127847,387040,235670,336611,721860,195512,514887,572281,917372,2202805,8.58,9.54,15.29,36.71,-0.96,11,12,1,-57394,25,19,USA,English,Second,Biomedical & Health Sciences,Female,the second one (triangular),
58e45df9d46cc6fa347e8902,848ON,experiment,foxtrot,3,longmire,axis,4,6,3,8,1,114659,505671,225099,304412,323366,426035,620330,529511,749401,2474019,10.34,8.83,12.49,41.23,1.51,10,11,1,90819,22,25,peru,Spanish,Fifth,Social Sciences (incl. CogSci),Male,the second one (triangular),
58e45df9d46cc6fa347e8903,EBFQN,experiment,foxtrot,0,axis,longmire,1,1,2,2,0,89195,146024,46732,141554,119487,830441,235219,188286,949928,1510910,3.92,3.14,15.83,25.18,0.78,2,4,2,46933,6,21,USA,English,Fourth,Social Sciences (incl. CogSci),Female,the first one (linear,
58e45df9d46cc6fa347e8904,G50Y1,experiment,foxtrot,3,longmire,axis,3,6,1,0,1,156024,663731,520001,722194,170484,487373,819755,1242195,657857,3073885,13.66,20.70,10.96,51.23,-7.04,9,1,-8,-422440,11,29,USA,English,Fifth,Social Sciences (incl. CogSci),Female,the first one (linear,
58e45df9d46cc6fa347e8905,B705H,experiment,foxtrot,2,longmire,axis,5,5,5,8,1,159871,610422,394891,436450,863269,117880,770293,831341,981149,3123454,12.84,13.86,16.35,52.06,-1.02,10,13,3,-61048,24,23,USA,Other,Fifth,Biomedical & Health Sciences,Female,the second one (triangular),
58e45df9d46cc6fa347e8906,G3HTX,experiment,foxtrot,0,axis,longmire,5,6,5,8,1,133057,266800,147065,446711,175707,579052,399857,593776,754759,2573197,6.66,9.90,12.58,42.89,-3.23,11,13,2,-193919,25,20,China,Mandarin or Cantonese,Second,Social Sciences (incl. CogSci),Female,the first one (linear,
58e45df9d46cc6fa347e8907,TAL8M,experiment,foxtrot,0,longmire,axis,5,7,1,1,0,87490,363800,225513,346761,165988,567159,451290,572274,733147,2051062,7.52,9.54,12.22,34.18,-2.02,12,2,-10,-120984,14,21,USA,English,Fourth,Social Sciences (incl. CogSci),Female,the first one (linear,
58e45df9d46cc6fa347e8908,OYVRD,experiment,foxtrot,2,axis,longmire,3,5,2,2,0,201411,376202,264009,595786,111108,431639,577613,859795,542747,2669329,9.63,14.33,9.05,44.49,-4.70,8,4,-4,-282182,12,19,USA,English,First,Social Sciences (incl. CogSci),Female,the first one (linear,
58e45df9d46cc6fa347e8909,12TUL,reverse,foxtrot,0,longmire,axis,5,9,4,8,1,138198,442784,266578,410230,420794,51659,580982,676808,472453,1992120,9.68,11.28,7.87,33.20,-1.60,14,12,-2,-95826,27,19,USA,English,Second,Social Sciences (incl. CogSci),Male,the second one (triangular),
58e45df9d46cc6fa347e890a,5SOSL,experiment,foxtrot,3,longmire,axis,4,6,0,0,0,104936,344619,137153,295682,356236,91927,449555,432835,448163,1564211,7.49,7.21,7.47,26.07,0.28,10,0,-10,16720,10,21,Philippines,Other,Third,Biomedical & Health Sciences,Female,the first one (linear,
58e45df9d46cc6fa347e890b,B2DME,experiment,foxtrot,0,axis,longmire,4,8,5,9,2,124036,326720,149258,254976,89833,932825,450756,404234,1022658,2253576,7.51,6.74,17.04,37.56,0.78,12,14,2,46522,28,21,United Kingdom,English,Third,Social Sciences (incl. CogSci),Female,the first one (linear,
58e45dcad46cc6fa347e80b1,BO123,experiment,golf,4,axis,longmire,3,8,5,5,2,280332,481351,177930,654560,170669,902562,761683,832490,1073231,3005988,12.69,13.87,17.89,50.10,-1.18,11,10,-1,-70807,23,22,USA,English,Fifth,Social Sciences (incl. CogSci),Male,the second one (triangular),
58e45dcad46cc6fa347e80b2,W4U0A,experiment,golf,0,axis,longmire,5,9,2,3,2,131233,407723,118142,628721,169371,721922,538956,746863,891293,2556579,8.98,12.45,14.85,42.61,-3.47,14,5,-9,-207907,21,21,USA,English,Fourth,Social Sciences (incl. CogSci),Female,the first one (linear,
58e45dcad46cc6fa347e80b3,HO7VP,experiment,golf,4,longmire,axis,4,6,4,6,2,83534,307290,179151,370738,230866,1013578,390824,549889,1244444,2432847,6.51,9.16,20.74,40.55,-2.65,10,10,0,-159065,22,20,Vietnam,Other,Third,Social Sciences (incl. CogSci),Female,the first one (linear,
58e45dcad46cc6fa347e80b4,19ZLL,experiment,golf,4,axis,longmire,3,6,3,7,0,196022,398254,168260,430291,856031,79548,594276,598551,935579,2438308,9.90,9.98,15.59,40.64,-0.07,9,10,1,-4275,19,18,USA,Mandarin or Cantonese,First,Biomedical & Health Sciences,Female,the first one (linear,
58e45dcad46cc6fa347e80b5,VRYKA,experiment,golf,0,axis,longmire,5,10,5,8,2,247783,655133,194642,574257,179505,848788,902916,768899,1028293,3098461,15.05,12.81,17.14,51.64,2.23,15,13,-2,134017,30,20,USA,Spanish,Third,Social Sciences (incl. CogSci),Female,the second one (triangular),
58e45dcad46cc6fa347e80b6,D2CRL,experiment,golf,0,longmire,axis,4,9,0,0,2,154807,511957,379583,389911,117422,580240,666764,769494,697662,2348153,11.11,12.82,11.63,39.14,-1.71,13,0,-13,-102730,15,22,USA,English,Fifth,Biomedical & Health Sciences,Female,the first one (linear,
58e45dcad46cc6fa347e80b7,8LQCF,reverse,golf,0,axis,longmire,5,6,4,5,0,107080,190754,77010,310271,82809,730289,297834,387281,813098,1690850,4.96,6.45,13.55,28.18,-1.49,11,9,-2,-89447,20,25,USA,English,Fifth,Social Sciences (incl. CogSci),Female,the first one (linear,
58e45dcad46cc6fa347e80b8,5OBUK,experiment,golf,4,longmire,axis,5,8,3,9,1,170732,518899,160620,386906,135489,662799,689631,547526,798288,2317952,11.49,9.13,13.30,38.63,2.37,13,12,-1,142105,26,23,USA,English,Fourth,Biomedical & Health Sciences,Male,the first one (linear,
58e45dcad46cc6fa347e80b9,R0DD9,experiment,golf,4,axis,longmire,4,5,4,7,1,210374,413512,175864,415363,584690,166859,623886,591227,751549,2222255,10.40,9.85,12.53,37.04,0.54,9,11,2,32659,21,20,USA,English,Fourth,Social Sciences (incl. CogSci),Female,the second one (triangular),
58e45dcad46cc6fa347e80ba,7HF5H,experiment,golf,0,axis,longmire,4,10,2,3,2,188012,339873,245735,687463,182850,568261,527885,933198,751111,2522253,8.80,15.55,12.52,42.04,-6.76,14,5,-9,-405313,21,20,Iran,Other,Second,Natural Sciences,Male,the first one (linear,
58e45dcad46cc6fa347e80bb,EK01F,reverse,golf,0,longmire,axis,4,6,1,5,0,105340,528910,197051,385906,335135,588316,634250,582957,923451,2495058,10.57,9.72,15.39,41.58,0.85,10,6,-4,51293,16,22,China,Mandarin or Cantonese,Third,Social Sciences (incl. CogSci),Female,the first one (linear,
58e45dcad46cc6fa347e80bc,WW14N,experiment,golf,2,longmire,axis,5,6,4,7,2,157573,528990,221781,357843,616768,154074,686563,579624,770842,2541329,11.44,9.66,12.85,42.36,1.78,11,11,0,106939,24,20,Mexico,English,Third,Humanities,Male,the second one (triangular),
58e45dcad46cc6fa347e80bd,MFPR7,experiment,golf,4,longmire,axis,5,9,4,7,2,119632,354176,208701,378723,310532,172887,473808,587424,483419,1797861,7.90,9.79,8.06,29.96,-1.89,14,11,-3,-113616,27,21,USA,English,Fourth,Biomedical & Health Sciences,Female,the first one (linear,
58e45dcad46cc6fa347e80be,9ZMW8,experiment,golf,2,longmire,axis,5,6,5,10,2,122912,291687,122865,222552,83818,522825,414599,345417,606643,2069666,6.91,5.76,10.11,34.49,1.15,11,15,4,69182,28,19,Korea,Other,Second,Social Sciences (incl. CogSci),Female,the second one (triangular),
58e45dcad46cc6fa347e80bf,DV3ER,experiment,golf,0,axis,longmire,5,10,3,8,1,142010,316509,154031,393201,143495,862788,458519,547232,1006283,2766646,7.64,9.12,16.77,46.11,-1.48,15,11,-4,-88713,27,20,USA,English,Second,Social Sciences (incl. CogSci),Female,the first one (linear,
58e45dcad46cc6fa347e80c0,89RBJ,experiment,golf,4,axis,longmire,5,8,5,10,2,241977,499318,178459,479190,336502,829621,741295,657649,1166123,2881795,12.35,10.96,19.44,48.03,1.39,13,15,2,83646,30,20,USA,Spanish,Third,Social Sciences (incl. CogSci),Female,the first one (linear,
58e45dcad46cc6fa347e80c1,YQDA2,experiment,golf,4,longmire,axis,5,8,2,6,1,138093,423676,159548,269689,125797,533941,561769,429237,659738,1930090,9.36,7.15,11.00,32.17,2.21,13,8,-5,132532,22,18,USA,English,First,Biomedical & Health Sciences,Female,the second one (triangular),
58e45dcad46cc6fa347e80c2,K5P3L,experiment,golf,4,longmire,axis,4,8,1,6,2,256833,416083,374898,418638,134522,435339,672916,793536,569861,2294313,11.22,13.23,9.50,38.24,-2.01,12,7,-5,-120620,21,21,USA,Other,Third,Biomedical & Health Sciences,Male,the first one (linear,
58e45dcad46cc6fa347e80c3,C02DT,experiment,golf,4,axis,longmire,5,6,5,8,1,135569,276039,95248,433081,483064,79894,411608,528329,562958,2030752,6.86,8.81,9.38,33.85,-1.95,11,13,2,-116721,25,20,USA,Mandarin or Cantonese,Second,Social Sciences (incl. CogSci),Female,the second one (triangular),
58e45d80d46cc6fa347e7aa8,Z10XW,reverse,hotel,4,axis,longmire,3,7,4,9,1,162334,415394,223771,526657,210668,1638056,577728,750428,1848724,3429892,9.63,12.51,30.81,57.16,-2.88,10,13,3,-172700,24,18,USA,English,First,Humanities,Female,the first one (linear,
58e45d80d46cc6fa347e7aa9,VJ2BM,reverse,hotel,4,axis,longmire,5,6,5,8,1,209990,432120,242096,760497,190201,869610,642110,1002593,1059811,3012797,10.70,16.71,17.66,50.21,-6.01,11,13,2,-360483,25,22,USA,Spanish,Fourth,Social Sciences (incl. CogSci),Female,the second one (triangular),
58e45d80d46cc6fa347e7aaa,LTQOU,reverse,hotel,4,longmire,axis,5,9,4,8,2,226997,529243,240893,409844,277577,951739,756240,650737,1229316,2949448,12.60,10.85,20.49,49.16,1.76,14,12,-2,105503,28,19,USA,English,Second,Biomedical & Health Sciences,Female,the second one (triangular),
58e45d80d46cc6fa347e7aab,JC60L,experiment,hotel,2,longmire,axis,4,4,4,7,0,96524,441043,214487,317123,241928,511135,537567,531610,753063,2103872,8.96,8.86,12.55,35.06,0.10,8,11,3,5957,19,19,USA,English,First,Biomedical & Health Sciences,Male,the second one (triangular),
58e45d80d46cc6fa347e7aac,R9VP8,reverse,hotel,4,longmire,axis,4,6,2,4,2,135580,352171,239132,696309,268829,569713,487751,935441,838542,2536861,8.13,15.59,13.98,42.28,-7.46,10,6,-4,-447690,18,25,Korea,Other,Fourth,Social Sciences (incl. CogSci),Female,the first one (linear,
58e45d80d46cc6fa347e7aad,QBQGZ,reverse,hotel,4,axis,longmire,4,7,5,7,2,182318,313328,175418,436123,115392,413284,495646,611541,528676,1956320,8.26,10.19,8.81,32.61,-1.93,11,12,1,-115895,25,23,Guangdong,Mandarin or Cantonese,Other,Social Sciences (incl. CogSci),Male,the first one (linear,
58e45d80d46cc6fa347e7aae,48ZDE,reverse,hotel,2,longmire,axis,4,6,1,0,0,141638,332482,177992,506330,1002009,135456,474120,684322,1137465,2548127,7.90,11.41,18.96,42.47,-3.50,10,1,-9,-210202,11,23,China,Mandarin or Cantonese,Fourth,Social Sciences (incl. CogSci),Female,the first one (linear,
58e45d80d46cc6fa347e7aaf,HDDC2,reverse,hotel,4,longmire,axis,4,4,3,8,2,141349,540112,196205,446558,245271,577705,681461,642763,822976,2455543,11.36,10.71,13.72,40.93,0.64,8,11,3,38698,21,21,India,Other,Third,Biomedical & Health Sciences,Female,the second one (triangular),
58e45d80d46cc6fa347e7ab0,UM82L,reverse,hotel,4,axis,longmire,5,7,5,10,1,153949,330287,198269,651058,141876,670935,484236,849327,812811,2438232,8.07,14.16,13.55,40.64,-6.08,12,15,3,-365091,28,19,USA,English,Second,Biomedical & Health Sciences,Male,the second one (triangular),
58e45d80d46cc6fa347e7ab1,5HR1X,reverse,hotel,3,longmire,axis,4,6,2,5,1,169896,676089,322392,743165,194998,554733,845985,1065557,749731,3088487,14.10,17.76,12.50,51.47,-3.66,10,7,-3,-219572,18,21,USA,Spanish,Fourth,Biomedical & Health Sciences,Female,the first one (linear,
58e45d80d46cc6fa347e7ab2,N0783,reverse,hotel,3,longmire,axis,4,6,4,7,1,128091,429446,242643,317581,623429,149441,557537,560224,772870,2197521,9.29,9.34,12.88,36.63,-0.04,10,11,1,-2687,22,22,TURKEY,Other,Fourth,Social Sciences (incl. CogSci),Female,the first one (linear,
58e45d80d46cc6fa347e7ab3,K015Z,experiment,hotel,3,longmire,axis,5,6,3,8,1,195498,582554,146878,351009,885111,74413,778052,497887,959524,2941130,12.97,8.30,15.99,49.02,4.67,11,11,0,280165,23,19,USA,English,Second,Math or Computer Sciences,Male,the second one (triangular),
58e45d80d46cc6fa347e7ab4,Z7V3J,reverse,hotel,4,longmire,axis,5,8,5,10,2,161514,467185,232402,415933,82431,769927,628699,648335,852358,2468519,10.48,10.81,14.21,41.14,-0.33,13,15,2,-19636,30,20,USA,English,Second,Biomedical & Health Sciences,Female,the second one (triangular),
58e45d80d46cc6fa347e7ab5,MP0MD,reverse,hotel,4,axis,longmire,5,7,4,9,2,156511,308336,113280,348872,241982,635526,464847,462152,877508,2137131,7.75,7.70,14.63,35.62,0.04,12,13,1,2695,27,20,USA,English,Third,Social Sciences (incl. CogSci),Female,the second one (triangular),
58e45d80d46cc6fa347e7ab6,WJHUD,reverse,hotel,2,axis,longmire,3,3,2,0,0,125144,191630,184991,272475,62325,714793,316774,457466,777118,1751730,5.28,7.62,12.95,29.20,-2.34,6,2,-4,-140692,8,22,USA,English,Fourth,Social Sciences (incl. CogSci),Female,the first one (linear,
58e45d80d46cc6fa347e7ab7,4CG7N,experiment,hotel,4,axis,longmire,4,7,4,6,1,271913,669796,282032,641646,178601,539176,941709,923678,717777,2908012,15.70,15.39,11.96,48.47,0.30,11,10,-1,18031,22,21,USA,English,Third,Biomedical & Health Sciences,Female,the second one (triangular),
58e45d80d46cc6fa347e7ab8,D0YUO,experiment,hotel,2,longmire,axis,5,4,1,0,2,131371,414306,252411,401331,102042,708644,545677,653742,810686,2224933,9.09,10.90,13.51,37.08,-1.80,9,1,-8,-108065,12,20,USA,Mandarin or Cantonese,Third,Social Sciences (incl. CogSci),Female,the first one (linear,
58e45d80d46cc6fa347e7ab9,4NF5A,reverse,hotel,4,axis,longmire,4,5,5,9,2,112896,274399,141638,320349,188706,528603,387295,461987,717309,1830937,6.45,7.70,11.96,30.52,-1.24,9,14,5,-74692,25,21,USA,English,Fourth,Social Sciences (incl. CogSci),Female,the first one (linear,
58e45d80d46cc6fa347e7aba,LN6PH,reverse,hotel,0,longmire,axis,5,8,2,0,1,149924,554473,405874,752630,230573,913784,704397,1158504,1144357,3238271,11.74,19.31,19.07,53.97,-7.57,13,2,-11,-454107,16,33,USA,English,Third,Social Sciences (incl. CogSci),Female,the first one (linear,
58e45d80d46cc6fa347e7abb,6FBAA,experiment,hotel,4,longmire,axis,4,6,3,6,1,141257,410629,130265,238523,100622,312908,551886,368788,413530,1560590,9.20,6.15,6.89,26.01,3.05,10,9,-1,183098,20,23,Iran,Other,Third,Biomedical & Health Sciences,Female,the second one (triangular),
58e45d80d46cc6fa347e7abc,K9QVH,experiment,hotel,0,axis,longmire,5,6,3,7,1,175314,321338,144328,415672,179159,757197,496652,560000,936356,2343899,8.28,9.33,15.61,39.06,-1.06,11,10,-1,-63348,22,27,Korea,Other,Third,Social Sciences (incl. CogSci),Male,the first one (linear,
58e45d80d46cc6fa347e7abd,S68K6,reverse,hotel,2,longmire,axis,4,8,1,0,1,121675,341511,401617,436389,96921,582575,463186,838006,679496,2281466,7.72,13.97,11.32,38.02,-6.25,12,1,-11,-374820,14,19,USA,Mandarin or Cantonese,Second,Social Sciences (incl. CogSci),Male,the first one (linear,
58e45d80d46cc6fa347e7abe,GTEE1,reverse,hotel,4,longmire,axis,4,9,3,10,2,156363,527035,247086,386808,95975,641044,683398,633894,737019,2467272,11.39,10.56,12.28,41.12,0.83,13,13,0,49504,28,18,USA,Spanish,First,Social Sciences (incl. CogSci),Male,the second one (triangular),
58e45d80d46cc6fa347e7abf,HAFD2,reverse,hotel,0,longmire,axis,3,6,1,1,0,91393,382627,170700,307201,614587,645812,474020,477901,1260399,2455948,7.90,7.97,21.01,40.93,-0.06,9,2,-7,-3881,11,21,USA,English,Third,Social Sciences (incl. CogSci),Female,the first one (linear,
58e45d80d46cc6fa347e7ac0,HCGK6,experiment,hotel,0,axis,longmire,5,8,2,3,1,162236,463867,359822,786651,230926,796720,626103,1146473,1027646,3097747,10.44,19.11,17.13,51.63,-8.67,13,5,-8,-520370,19,19,USA,English,Second,Social Sciences (incl. CogSci),Male,the first one (linear,
58e45d80d46cc6fa347e7ac1,OXMZM,reverse,hotel,4,longmire,axis,5,8,4,6,2,102622,311843,144043,323224,100330,385079,414465,467267,485409,1610469,6.91,7.79,8.09,26.84,-0.88,13,10,-3,-52802,25,18,USA,English,First,Natural Sciences,Female,the first one (linear,
58e45d3bd46cc6fa347e72a7,T42AO,reverse,india,0,longmire,axis,4,6,1,3,0,134838,418529,303859,672016,514687,197603,553367,975875,712290,2537333,9.22,16.26,11.87,42.29,-7.04,10,4,-6,-422508,14,21,USA,English,Third,Social Sciences (incl. CogSci),Male,the second one (triangular),
58e45d3bd46cc6fa347e72a8,SUCUA,experiment,india,4,axis,longmire,5,8,5,10,1,636112,747207,200547,405701,96924,541249,1383319,606248,638173,2899105,23.06,10.10,10.64,48.32,12.95,13,15,2,777071,29,21,KENYA,Other,Third,Biomedical & Health Sciences,Female,the first one (linear,
58e45d3bd46cc6fa347e72a9,M8MYD,experiment,india,2,axis,longmire,2,9,5,9,2,185596,310679,232005,478296,129512,869622,496275,710301,999134,2433601,8.27,11.84,16.65,40.56,-3.57,11,14,3,-214026,27,19,USA,English,Second,Biomedical & Health Sciences,Female,the first one (linear,
58e45d3bd46cc6fa347e72aa,7HDR0,reverse,india,0,longmire,axis,5,7,5,8,1,100625,401383,165944,549435,123060,737641,502008,715379,860701,2357531,8.37,11.92,14.35,39.29,-3.56,12,13,1,-213371,26,19,USA,English,Second,Social Sciences (incl. CogSci),Male,the second one (triangular),
58e45d3bd46cc6fa347e72ab,HZMPX,experiment,india,0,axis,longmire,4,7,5,8,2,108756,346587,148850,270036,84954,481523,455343,418886,566477,1696135,7.59,6.98,9.44,28.27,0.61,11,13,2,36457,26,20,USA,English,Third,Biomedical & Health Sciences,Female,the first one (linear,
58e45d3bd46cc6fa347e72ac,SPP2M,experiment,india,4,axis,longmire,3,7,4,9,2,172246,388797,211507,403631,300190,611852,561043,615138,912042,2349180,9.35,10.25,15.20,39.15,-0.90,10,13,3,-54095,25,19,USA,English,Second,Social Sciences (incl. CogSci),Female,the first one (linear,
58e45d3bd46cc6fa347e72ad,TW6BB,reverse,india,4,longmire,axis,3,7,3,7,2,131686,350850,266448,415368,115957,725246,482536,681816,841203,2250600,8.04,11.36,14.02,37.51,-3.32,10,10,0,-199280,22,22,USA,English,Fourth,Humanities,Female,the second one (triangular),
58e45d3bd46cc6fa347e72ae,1BZ30,experiment,india,4,longmire,axis,5,7,2,8,0,137465,440943,215470,228250,235635,685612,578408,443720,921247,2241066,9.64,7.40,15.35,37.35,2.24,12,10,-2,134688,22,20,USA,English,Third,Biomedical & Health Sciences,Female,the first one (linear,
58e45d3bd46cc6fa347e72af,S3UR3,experiment,india,0,axis,longmire,5,8,3,7,2,188218,438048,242908,612679,123198,442394,626266,855587,565592,2300970,10.44,14.26,9.43,38.35,-3.82,13,10,-3,-229321,25,18,USA,English,First,Social Sciences (incl. CogSci),Male,the first one (linear,
58e45d3bd46cc6fa347e72b0,1KNSY,reverse,india,0,axis,longmire,5,5,2,2,2,172455,455471,202943,465598,138524,466000,627926,668541,604524,2063665,10.47,11.14,10.08,34.39,-0.68,10,4,-6,-40615,16,21,india,English,Fourth,Biomedical & Health Sciences,Female,the first one (linear,
58e45d3bd46cc6fa347e72b1,O0XHK,reverse,india,4,longmire,axis,4,8,4,10,1,128961,398548,212210,398232,184281,478396,527509,610442,662677,2067321,8.79,10.17,11.04,34.46,-1.38,12,14,2,-82933,27,20,USA,English,Third,Social Sciences (incl. CogSci),Female,the second one (triangular),
58e45d3bd46cc6fa347e72b2,QVNGE,experiment,india,3,longmire,axis,3,6,1,8,2,102723,306229,199101,206941,97398,500469,408952,406042,597867,1636360,6.82,6.77,9.96,27.27,0.05,9,9,0,2910,20,21,Korea,Other,Third,Biomedical & Health Sciences,Male,the second one (triangular),
58e45d3bd46cc6fa347e72b3,XEW4X,experiment,india,4,axis,longmire,4,8,4,8,2,137844,296302,132133,314176,158155,627882,434146,446309,786037,1906739,7.24,7.44,13.10,31.78,-0.20,12,12,0,-12163,26,20,USA,English,Third,Biomedical & Health Sciences,Female,the first one (linear,
58e45d3bd46cc6fa347e72b4,HNVWH,experiment,india,3,axis,longmire,5,7,4,6,1,155946,409083,193834,648751,154674,495669,565029,842585,650343,2349107,9.42,14.04,10.84,39.15,-4.63,12,10,-2,-277556,23,20,China,Mandarin or Cantonese,Third,Math or Computer Sciences,Female,the first one (linear,
58e45d3bd46cc6fa347e72b5,55QTL,experiment,india,3,axis,longmire,4,8,4,8,1,287843,486599,189126,470181,115146,1319787,774442,659307,1434933,3173189,12.91,10.99,23.92,52.89,1.92,12,12,0,115135,25,20,China,Mandarin or Cantonese,Second,Social Sciences (incl. CogSci),Female,the first one (linear,
58e45d3bd46cc6fa347e72b6,JXWJP,reverse,india,4,axis,longmire,4,7,5,8,1,134890,291658,125992,436999,114439,698398,426548,562991,812837,2070209,7.11,9.38,13.55,34.50,-2.27,11,13,2,-136443,25,20,USA,English,Third,Social Sciences (incl. CogSci),Female,the second one (triangular),
58e45d3bd46cc6fa347e72b7,GHT14,experiment,india,0,longmire,axis,4,8,1,0,2,92206,417764,446999,399195,120206,387212,509970,846194,507418,2061037,8.50,14.10,8.46,34.35,-5.60,12,1,-11,-336224,15,23,VIETNAM,Other,Fourth,Biomedical & Health Sciences,Male,the first one (linear,
58e45d3bd46cc6fa347e72b8,82SJ2,reverse,india,4,axis,longmire,3,2,1,0,0,178687,230618,121793,248635,14107,631532,409305,370428,645639,1646268,6.82,6.17,10.76,27.44,0.65,5,1,-4,38877,6,24,USA,English,Fourth,Social Sciences (incl. CogSci),Male,the first one (linear,
58e45d3bd46cc6fa347e72b9,F8PZP,reverse,india,4,longmire,axis,4,5,4,6,0,118970,382667,181639,218406,73759,191704,501637,400045,265463,1346061,8.36,6.67,4.42,22.43,1.69,9,10,1,101592,19,20,Pakistan,Other,Third,Biomedical & Health Sciences,Female,the first one (linear,
58e45d3bd46cc6fa347e72ba,J7RKX,experiment,india,2,longmire,axis,5,8,4,8,2,139503,424732,129143,236706,77390,462301,564235,365849,539691,1763772,9.40,6.10,8.99,29.40,3.31,13,12,-1,198386,27,19,USA,English,Second,Engineering,Female,the second one (triangular),
58e45d3bd46cc6fa347e72bb,XKUQ9,experiment,india,3,axis,longmire,5,8,3,9,1,232370,548430,168997,591422,174582,702513,780800,760419,877095,2786895,13.01,12.67,14.62,46.45,0.34,13,12,-1,20381,26,24,USA,English,Fourth,Social Sciences (incl. CogSci),Female,the first one (linear,
58e45d3bd46cc6fa347e72bc,5KVW9,experiment,india,2,axis,longmire,3,3,1,2,2,118641,196159,105441,287356,339818,83022,314800,392797,422840,1361200,5.25,6.55,7.05,22.69,-1.30,6,3,-3,-77997,11,23,Canada,English,Fourth,Social Sciences (incl. CogSci),Female,the first one (linear,
58e45d3bd46cc6fa347e72bd,VEL2Z,experiment,india,2,axis,longmire,4,7,4,10,1,198305,278705,110380,256096,141097,331389,477010,366476,472486,1531107,7.95,6.11,7.87,25.52,1.84,11,14,3,110534,26,21,USA,English,Third,Social Sciences (incl. CogSci),Female,the second one (triangular),
58e45d3bd46cc6fa347e72be,N0V08,experiment,india,0,axis,longmire,4,8,4,7,2,91563,223213,112402,311187,354600,22084,314776,423589,376684,1314584,5.25,7.06,6.28,21.91,-1.81,12,11,-1,-108813,25,18,USA,Other,First,Biomedical & Health Sciences,Female,the second one (triangular),
58e45ca4d46cc6fa347e6b36,GFNM7,experiment,juliet,1,longmire,axis,4,8,2,7,0,229869,696819,390231,411375,96728,1140003,926688,801606,1236731,3392647,15.44,13.36,20.61,56.54,2.08,12,9,-3,125082,21,21,USA,English,Fourth,Social Sciences (incl. CogSci),Female,the first one (linear,
58e45ca4d46cc6fa347e6b37,9W7JK,reverse,juliet,1,longmire,axis,3,5,1,8,1,178536,660824,418439,566365,320900,720050,839360,984804,1040950,3320006,13.99,16.41,17.35,55.33,-2.42,8,9,1,-145444,18,21,USA,Spanish,Third,Social Sciences (incl. CogSci),Female,the first one (linear,
58e45ca4d46cc6fa347e6b38,DEV73,reverse,juliet,1,axis,longmire,4,9,5,9,2,168144,402121,226549,462132,135023,648899,570265,688681,783922,2494900,9.50,11.48,13.07,41.58,-1.97,13,14,1,-118416,29,22,USA,English,Fourth,Social Sciences (incl. CogSci),Female,the second one (triangular),
58e45ca4d46cc6fa347e6b39,O1MDT,experiment,juliet,1,axis,longmire,4,4,2,1,1,201956,283321,271308,383760,1314862,120548,485277,655068,1435410,3019869,8.09,10.92,23.92,50.33,-2.83,8,3,-5,-169791,12,25,USA,English,Other,Social Sciences (incl. CogSci),Female,the first one (linear,
58e45ca4d46cc6fa347e6b3a,HO8HO,experiment,juliet,1,longmire,axis,5,6,4,6,0,198928,554063,229781,361232,297090,638257,752991,591013,935347,2755243,12.55,9.85,15.59,45.92,2.70,11,10,-1,161978,21,21,USA,Spanish,Third,Social Sciences (incl. CogSci),Female,the first one (linear,
58e45ca4d46cc6fa347e6b3b,RQMEB,experiment,juliet,1,longmire,axis,3,7,1,0,2,175584,408531,313149,475448,119353,670308,584115,788597,789661,2672833,9.74,13.14,13.16,44.55,-3.41,10,1,-9,-204482,13,22,USA,English,Fourth,Social Sciences (incl. CogSci),Male,the first one (linear,
58e45ca4d46cc6fa347e6b3c,YOK7W,experiment,juliet,1,axis,longmire,4,9,5,8,2,162000,388031,309255,397459,149655,858012,550031,706714,1007667,2727296,9.17,11.78,16.79,45.45,-2.61,13,13,0,-156683,28,20,China,Mandarin or Cantonese,Second,Social Sciences (incl. CogSci),Male,the second one (triangular),
58e45ca4d46cc6fa347e6b3d,VOQB1,experiment,juliet,4,longmire,axis,5,6,5,8,2,138618,444919,322659,378120,143183,490735,583537,700779,633918,2196339,9.73,11.68,10.57,36.61,-1.95,11,13,2,-117242,26,23,USA,Other,Third,Biomedical & Health Sciences,Female,the second one (triangular),
58e45ca4d46cc6fa347e6b3e,STLX2,reverse,juliet,1,longmire,axis,4,7,4,10,1,126626,484582,224977,363836,822870,108989,611208,588813,931859,2585302,10.19,9.81,15.53,43.09,0.37,11,14,3,22395,26,20,USA,English,Second,Social Sciences (incl. CogSci),Female,the second one (triangular),
58e45ca4d46cc6fa347e6b3f,G377V,reverse,juliet,1,longmire,axis,4,8,3,7,2,153865,406791,279249,379178,110296,756719,560656,658427,867015,2521189,9.34,10.97,14.45,42.02,-1.63,12,10,-2,-97771,24,20,USA,English,Second,Math or Computer Sciences,Male,the second one (triangular),
58e45ca4d46cc6fa347e6b40,9RMN6,experiment,juliet,1,axis,longmire,5,7,4,8,2,185368,420502,193378,381328,140760,676042,605870,574706,816802,2417716,10.10,9.58,13.61,40.30,0.52,12,12,0,31164,26,22,USA,Other,Fourth,Social Sciences (incl. CogSci),Female,the second one (triangular),
58e45ca4d46cc6fa347e6b41,3L53C,experiment,juliet,1,axis,longmire,5,7,3,9,2,169680,311360,186874,463327,142145,633295,481040,650201,775440,2304395,8.02,10.84,12.92,38.41,-2.82,12,12,0,-169161,26,21,USA,Mandarin or Cantonese,Fourth,Social Sciences (incl. CogSci),Male,the second one (triangular),
58e45ca4d46cc6fa347e6b42,2610Q,experiment,juliet,4,axis,longmire,5,5,5,10,2,198575,369617,198930,309095,121029,932186,568192,508025,1053215,2500420,9.47,8.47,17.55,41.67,1.00,10,15,5,60167,27,19,USA,English,Second,Biomedical & Health Sciences,Female,the first one (linear,
58e45ca4d46cc6fa347e6b43,ZR1KM,reverse,juliet,1,longmire,axis,4,7,1,0,1,103059,296772,266306,432231,86869,361421,399831,698537,448290,1925179,6.66,11.64,7.47,32.09,-4.98,11,1,-10,-298706,13,21,USA,Mandarin or Cantonese,Fourth,Biomedical & Health Sciences,Male,the first one (linear,
58e45ca4d46cc6fa347e6b44,M3AYQ,experiment,juliet,4,axis,longmire,4,9,5,9,1,129734,363423,88798,376048,182197,962735,493157,464846,1144932,2499532,8.22,7.75,19.08,41.66,0.47,13,14,1,28311,28,21,Canada,English,Third,Social Sciences (incl. CogSci),Female,the first one (linear,
58e45ca4d46cc6fa347e6b45,0YH05,reverse,juliet,1,axis,longmire,4,9,5,8,2,127547,245656,118415,217142,162691,441470,373203,335557,604161,1694999,6.22,5.59,10.07,28.25,0.63,13,13,0,37646,28,19,China,English,Second,Biomedical & Health Sciences,Female,the first one (linear,
58e45ca4d46cc6fa347e6b46,QP9F4,experiment,juliet,1,longmire,axis,4,4,1,2,1,160536,427708,209748,317492,533224,297401,588244,527240,830625,2323129,9.80,8.79,13.84,38.72,1.02,8,3,-5,61004,12,21,China,English,Third,Social Sciences (incl. CogSci),Female,the first one (linear,
58e45ca4d46cc6fa347e6b47,C7Q4N,experiment,juliet,1,longmire,axis,3,4,2,8,1,181805,370971,220025,234185,80766,837224,552776,454210,917990,2274602,9.21,7.57,15.30,37.91,1.64,7,10,3,98566,18,19,USA,English,First,Social Sciences (incl. CogSci),Female,the first one (linear,
58e45ca4d46cc6fa347e6b48,ZRVFN,reverse,juliet,1,axis,longmire,5,10,3,8,1,127347,425079,154618,412803,81648,671040,552426,567421,752688,2199332,9.21,9.46,12.54,36.66,-0.25,15,11,-4,-14995,27,20,USA,English,Second,Social Sciences (incl. CogSci),Male,the second one (triangular),
58e45ca4d46cc6fa347e6b49,7VJSF,experiment,juliet,1,axis,longmire,4,6,5,8,2,247392,508587,270021,625509,236975,621256,755979,895530,858231,2976392,12.60,14.93,14.30,49.61,-2.33,10,13,3,-139551,25,18,USA,Spanish,First,Biomedical & Health Sciences,Male,the first one (linear,
58e45ca4d46cc6fa347e6b4a,KAT2Z,experiment,juliet,4,longmire,axis,5,5,2,4,0,210584,420701,206351,583291,208092,505511,631285,789642,713603,2476244,10.52,13.16,11.89,41.27,-2.64,10,6,-4,-158357,16,20,USA,English,Second,Fine Arts,Male,the first one (linear,
58e45ca4d46cc6fa347e6b4b,NEVPT,experiment,juliet,4,axis,longmire,5,5,4,7,1,179064,381512,150986,309167,458601,304778,560576,460153,763379,2173682,9.34,7.67,12.72,36.23,1.67,10,11,1,100423,22,18,China,Mandarin or Cantonese,First,Social Sciences (incl. CogSci),Female,the second one (triangular),
58e45ca4d46cc6fa347e6b4c,OWMTU,experiment,juliet,4,axis,longmire,3,6,5,8,0,191884,400683,131897,302002,45962,586012,592567,433899,631974,2030201,9.88,7.23,10.53,33.84,2.64,9,13,4,158668,22,21,USA,English,Fourth,Biomedical & Health Sciences,Male,the second one (triangular),
58e45ca4d46cc6fa347e6b4d,GFLB2,reverse,juliet,1,longmire,axis,3,6,1,5,1,132713,319069,299984,349229,177510,852973,451782,649213,1030483,2490905,7.53,10.82,17.17,41.52,-3.29,9,6,-3,-197431,16,20,USA,English,Third,Social Sciences (incl. CogSci),Male,the first one (linear,
58e45ca4d46cc6fa347e6b4e,4UBJB,experiment,juliet,4,longmire,axis,3,5,4,7,0,91474,437635,216247,290660,160019,182989,529109,506907,343008,1718210,8.82,8.45,5.72,28.64,0.37,8,11,3,22202,19,22,USA,English,Third,Social Sciences (incl. CogSci),Female,the first one (linear,
58e45c5cd46cc6fa347e637b,WS8KM,experiment,kilo,1,longmire,axis,5,7,2,8,1,188644,538358,273269,424650,175483,1752394,727002,697919,1927877,3647145,12.12,11.63,32.13,60.79,0.48,12,10,-2,29083,23,21,USA,English,Fourth,Social Sciences (incl. CogSci),Female,the first one (linear,
58e45c5cd46cc6fa347e637c,41M35,experiment,kilo,1,longmire,axis,5,9,1,1,2,185641,663855,403242,1205815,113099,432754,849496,1609057,545853,3344981,14.16,26.82,9.10,55.75,-12.66,14,2,-12,-759561,18,21,USA,English,Third,Social Sciences (incl. CogSci),Female,the first one (linear,
58e45c5cd46cc6fa347e637d,UXLVN,experiment,kilo,1,longmire,axis,4,5,3,8,1,133223,422789,321157,413589,155423,1328269,556012,734746,1483692,3125846,9.27,12.25,24.73,52.10,-2.98,9,11,2,-178734,21,19,USA,English,First,Social Sciences (incl. CogSci),Female,the first one (linear,
58e45c5cd46cc6fa347e637e,4GZS0,reverse,kilo,4,longmire,axis,5,4,4,7,2,127910,468169,241545,544601,223633,940562,596079,786146,1164195,3002546,9.93,13.10,19.40,50.04,-3.17,9,11,2,-190067,22,23,USA,English,Third,Social Sciences (incl. CogSci),Female,the second one (triangular),
58e45c5cd46cc6fa347e637f,TZF8P,reverse,kilo,1,axis,longmire,5,9,5,9,2,166548,377520,185782,300305,255645,1215357,544068,486087,1471002,2846428,9.07,8.10,24.52,47.44,0.97,14,14,0,57981,30,19,USA,English,First,Humanities,Male,the second one (triangular),
58e45c5cd46cc6fa347e6380,0CDY7,experiment,kilo,1,longmire,axis,5,6,3,6,1,126416,336121,227191,278381,146862,546478,462537,505572,693340,2626072,7.71,8.43,11.56,43.77,-0.72,11,9,-2,-43035,21,21,China,Mandarin or Cantonese,Fourth,Biomedical & Health Sciences,Female,the first one (linear,
58e45c5cd46cc6fa347e6381,5AW04,experiment,kilo,4,longmire,axis,3,9,5,8,2,193291,495511,226208,354735,191465,837147,688802,580943,1028612,2675464,11.48,9.68,17.14,44.59,1.80,12,13,1,107859,27,22,USA,Spanish,Fifth,Natural Sciences,Female,the second one (triangular),
58e45c5cd46cc6fa347e6382,Q3T3X,experiment,kilo,1,longmire,axis,5,9,3,7,1,180863,478601,291921,298843,208930,782729,659464,590764,991659,2589673,10.99,9.85,16.53,43.16,1.15,14,10,-4,68700,25,20,USA,Mandarin or Cantonese,Third,Social Sciences (incl. CogSci),Female,the first one (linear,
58e45c5cd46cc6fa347e6383,YNWL4,reverse,kilo,4,axis,longmire,4,8,3,9,2,191285,421053,187092,410753,122940,764273,612338,597845,887213,2479884,10.21,9.96,14.79,41.33,0.24,12,12,0,14493,26,20,China,Mandarin or Cantonese,Second,Social Sciences (incl. CogSci),Male,the second one (triangular),
58e45c5cd46cc6fa347e6384,45B1U,experiment,kilo,4,axis,longmire,5,7,5,7,2,154085,319859,136542,505005,77657,735756,473944,641547,813413,2243420,7.90,10.69,13.56,37.39,-2.79,12,12,0,-167603,26,19,United Arab Emirates,Other,Third,Math or Computer Sciences,Female,the first one (linear,
58e45c5cd46cc6fa347e6385,XV5ZB,reverse,kilo,1,axis,longmire,4,6,2,2,0,162938,243100,184022,389819,143745,917402,406038,573841,1061147,2455700,6.77,9.56,17.69,40.93,-2.80,10,4,-6,-167803,14,19,USA,Spanish,Second,Fine Arts,Female,the first one (linear,
58e45c5cd46cc6fa347e6386,S0MEG,reverse,kilo,1,longmire,axis,4,4,1,0,0,132637,328279,177692,227298,88791,41493,460916,404990,130284,1255624,7.68,6.75,2.17,20.93,0.93,8,1,-7,55926,9,20,USA,English,Third,Social Sciences (incl. CogSci),Female,the first one (linear,
58e45c5cd46cc6fa347e6387,T263H,experiment,kilo,4,longmire,axis,4,9,4,8,2,150145,369518,161814,386488,120146,719030,519663,548302,839176,2264896,8.66,9.14,13.99,37.75,-0.48,13,12,-1,-28639,27,18,USA,English,First,Humanities,Female,the second one (triangular),
58e45c5cd46cc6fa347e6388,QQDWJ,experiment,kilo,1,axis,longmire,5,8,4,5,0,178824,396969,216335,805649,111163,808283,575793,1021984,919446,2971188,9.60,17.03,15.32,49.52,-7.44,13,9,-4,-446191,22,21,USA,English,Third,Social Sciences (incl. CogSci),Other,the first one (linear,
58e45c5cd46cc6fa347e6389,4P4ZR,reverse,kilo,1,longmire,axis,4,8,0,1,1,125567,386696,214321,312562,171826,785545,512263,526883,957371,2290033,8.54,8.78,15.96,38.17,-0.24,12,1,-11,-14620,14,21,USA,English,Fourth,Social Sciences (incl. CogSci),Female,the first one (linear,
58e45c5cd46cc6fa347e638a,N7XN2,reverse,kilo,1,longmire,axis,4,7,4,5,1,139217,507482,231132,311977,156390,431875,646699,543109,588265,2200341,10.78,9.05,9.80,36.67,1.73,11,9,-2,103590,21,21,USA,English,Fourth,Biomedical & Health Sciences,Female,the second one (triangular),
58e45c5cd46cc6fa347e638b,13P8A,reverse,kilo,1,axis,longmire,4,6,5,9,2,141417,270184,143488,408931,115266,625665,411601,552419,740931,2057688,6.86,9.21,12.35,34.29,-2.35,10,14,4,-140818,26,19,USA,English,First,Social Sciences (incl. CogSci),Female,the first one (linear,
58e45c5cd46cc6fa347e638c,G56GO,experiment,kilo,4,longmire,axis,4,9,5,8,2,157513,531920,200192,388854,182757,1495642,689433,589046,1678399,3190358,11.49,9.82,27.97,53.17,1.67,13,13,0,100387,28,18,USA,English,First,Social Sciences (incl. CogSci),Female,the second one (triangular),
58e45c5cd46cc6fa347e638d,CMXGY,experiment,kilo,4,axis,longmire,3,5,2,9,0,155720,371870,138626,490572,197278,538755,527590,629198,736033,2185049,8.79,10.49,12.27,36.42,-1.69,8,11,3,-101608,19,21,USA,Spanish,Third,Social Sciences (incl. CogSci),Female,the first one (linear,
58e45c5cd46cc6fa347e638e,YJN84,experiment,kilo,1,longmire,axis,5,6,5,6,1,139589,459197,195076,405041,111210,765351,598786,600117,876561,2377095,9.98,10.00,14.61,39.62,-0.02,11,11,0,-1331,23,18,Canada,Mandarin or Cantonese,First,Natural Sciences,Female,the first one (linear,
58e45c5cd46cc6fa347e638f,4S72Y,reverse,kilo,4,longmire,axis,5,8,3,9,2,98211,378950,158948,289614,137147,502802,477161,448562,639949,1883856,7.95,7.48,10.67,31.40,0.48,13,12,-1,28599,27,18,USA,English,First,Social Sciences (incl. CogSci),Female,the second one (triangular),
58e45c5cd46cc6fa347e6390,83WD2,experiment,kilo,1,longmire,axis,4,9,1,0,1,116961,303409,237318,320048,131706,758173,420370,557366,889879,2164700,7.01,9.29,14.83,36.08,-2.28,13,1,-12,-136996,15,21,China,Mandarin or Cantonese,Third,Biomedical & Health Sciences,Female,the first one (linear,
58e45c5cd46cc6fa347e6391,V37VJ,reverse,kilo,1,axis,longmire,4,5,5,8,2,139800,335541,139346,403998,209894,620815,475341,543344,830709,2151051,7.92,9.06,13.85,35.85,-1.13,9,13,4,-68003,24,19,Korea,Other,First,Social Sciences (incl. CogSci),Male,the second one (triangular),
58e45c5cd46cc6fa347e6392,XX3HL,reverse,kilo,1,longmire,axis,5,7,4,7,1,117052,447765,196095,280265,152519,531376,564817,476360,683895,2100668,9.41,7.94,11.40,35.01,1.47,12,11,-1,88457,24,20,USA,Spanish,Second,Engineering,Male,the second one (triangular),
58e45c5cd46cc6fa347e6393,GQ13P,reverse,kilo,1,longmire,axis,4,5,1,0,2,78280,288559,357386,397239,106537,491972,366839,754625,598509,2000882,6.11,12.58,9.98,33.35,-6.46,9,1,-8,-387786,12,19,USA,English,First,Fine Arts,Female,the first one (linear,
58e45c5cd46cc6fa347e6394,7UDVY,experiment,kilo,4,longmire,axis,4,9,3,7,0,132766,337178,144264,388913,164748,111306,469944,533177,276054,1625400,7.83,8.89,4.60,27.09,-1.05,13,10,-3,-63233,23,22,USA,English,Fourth,Social Sciences (incl. CogSci),Female,the second one (triangular),
58e45c5cd46cc6fa347e6395,R70BB,experiment,kilo,1,axis,longmire,4,6,4,9,1,327089,543862,335159,473570,817854,121913,870951,808729,939767,3146162,14.52,13.48,15.66,52.44,1.04,10,13,3,62222,24,19,China,Mandarin or Cantonese,First,Natural Sciences,Male,the second one (triangular),
58e45c5cd46cc6fa347e6396,220F7,experiment,kilo,1,longmire,axis,4,6,0,8,2,105831,258747,251368,389793,142568,456845,364578,641161,599413,1983799,6.08,10.69,9.99,33.06,-4.61,10,8,-2,-276583,20,18,USA,Spanish,First,Humanities,Female,the first one (linear,
58e45c2bd46cc6fa347e5ae4,40XZB,experiment,lima,1,longmire,axis,4,3,1,3,0,182273,584583,630185,545670,1390182,291427,766856,1175855,1681609,3967033,12.78,19.60,28.03,66.12,-6.82,7,4,-3,-408999,11,25,USA,Other,Third,Social Sciences (incl. CogSci),Female,the first one (linear,
58e45c2bd46cc6fa347e5ae5,SL5GG,reverse,lima,1,axis,longmire,2,3,3,4,1,171843,461452,271822,494431,1214616,138672,633295,766253,1353288,3062240,10.55,12.77,22.55,51.04,-2.22,5,7,2,-132958,13,20,USA,English,Third,Biomedical & Health Sciences,Female,the first one (linear,
58e45c2bd46cc6fa347e5ae6,1DJQB,experiment,lima,4,longmire,axis,5,7,3,8,2,240609,632656,203166,511657,200272,941727,873265,714823,1141999,3085555,14.55,11.91,19.03,51.43,2.64,12,11,-1,158442,25,21,Mexico,Spanish,Fourth,Social Sciences (incl. CogSci),Female,the second one (triangular),
58e45c2bd46cc6fa347e5ae7,0Z1HR,reverse,lima,1,longmire,axis,4,8,2,8,2,197157,557402,330665,563864,214079,850793,754559,894529,1064872,3025124,12.58,14.91,17.75,50.42,-2.33,12,10,-2,-139970,24,18,USA,English,First,Social Sciences (incl. CogSci),Female,the first one (linear,
58e45c2bd46cc6fa347e5ae8,HJ1HN,experiment,lima,1,longmire,axis,4,5,3,4,1,178983,548138,323697,430732,170016,975276,727121,754429,1145292,3017807,12.12,12.57,19.09,50.30,-0.46,9,7,-2,-27308,17,19,USA,Spanish,Second,Social Sciences (incl. CogSci),Female,the first one (linear,
58e45c2bd46cc6fa347e5ae9,Y4D6B,experiment,lima,1,longmire,axis,5,9,5,8,2,171416,480845,215843,375828,573451,291639,652261,591671,865090,2480247,10.87,9.86,14.42,41.34,1.01,14,13,-1,60590,29,18,USA,English,First,Engineering,Male,the second one (triangular),
58e45c2bd46cc6fa347e5aea,KX6W7,reverse,lima,4,longmire,axis,4,6,5,9,2,143171,582570,203856,392099,102021,713824,725741,595955,815845,2427338,12.10,9.93,13.60,40.46,2.16,10,14,4,129786,26,19,USA,English,First,Social Sciences (incl. CogSci),Female,the second one (triangular),
58e45c2bd46cc6fa347e5aeb,T08QA,experiment,lima,4,longmire,axis,4,6,4,6,2,144151,514951,185241,454130,135398,599481,659102,639371,734879,2442199,10.99,10.66,12.25,40.70,0.33,10,10,0,19731,22,20,USA,English,Third,Biomedical & Health Sciences,Female,the second one (triangular),
58e45c2bd46cc6fa347e5aec,ZZUMG,experiment,lima,4,longmire,axis,5,8,5,9,2,147357,341053,145956,334145,97233,785373,488410,480101,882606,2307594,8.14,8.00,14.71,38.46,0.14,13,14,1,8309,29,21,China,Mandarin or Cantonese,Third,Social Sciences (incl. CogSci),Male,the second one (triangular),
58e45c2bd46cc6fa347e5aed,D1Y3M,reverse,lima,4,axis,longmire,5,4,5,5,2,162357,303173,247710,434448,123614,630564,465530,682158,754178,2205090,7.76,11.37,12.57,36.75,-3.61,9,10,1,-216628,21,21,USA,Mandarin or Cantonese,Fourth,Natural Sciences,Female,the second one (triangular),
58e45c2bd46cc6fa347e5aee,WFZSV,reverse,lima,1,longmire,axis,4,9,2,10,1,142666,592299,409694,538350,161642,688369,734965,948044,850011,3034873,12.25,15.80,14.17,50.58,-3.55,13,12,-1,-213079,26,18,China,Mandarin or Cantonese,First,Social Sciences (incl. CogSci),Female,the first one (linear,
58e45c2bd46cc6fa347e5aef,VZJRM,reverse,lima,0,axis,longmire,4,8,3,8,2,147796,248842,125326,318884,507158,85949,396638,444210,593107,1778083,6.61,7.40,9.89,29.63,-0.79,12,11,-1,-47572,25,19,Taiwan,Mandarin or Cantonese,First,Biomedical & Health Sciences,Female,the first one (linear,
58e45c2bd46cc6fa347e5af0,VG4GF,experiment,lima,1,axis,longmire,4,6,5,8,2,132559,233141,180518,378039,112663,466969,365700,558557,579632,1842588,6.10,9.31,9.66,30.71,-3.21,10,13,3,-192857,25,19,USA,English,Second,Social Sciences (incl. CogSci),Female,the first one (linear,
58e45c2bd46cc6fa347e5af1,53E5K,experiment,lima,1,longmire,axis,4,5,0,6,1,101776,309764,217167,340931,136683,491150,411540,558098,627833,2181598,6.86,9.30,10.46,36.36,-2.44,9,6,-3,-146558,16,18,China,Mandarin or Cantonese,First,Math or Computer Sciences,Male,the second one (triangular),
58e45c2bd46cc6fa347e5af2,9ZW9M,reverse,lima,4,longmire,axis,5,8,2,5,2,105691,422587,167761,333856,549648,216589,528278,501617,766237,2141654,8.80,8.36,12.77,35.69,0.44,13,7,-6,26661,22,21,USA,English,Third,Social Sciences (incl. CogSci),Female,the second one (triangular),
58e45c2bd46cc6fa347e5af3,0R4YC,experiment,lima,1,axis,longmire,5,10,4,9,2,151050,369462,127889,381998,432462,408778,520512,509887,841240,2207844,8.68,8.50,14.02,36.80,0.18,15,13,-2,10625,30,20,Mexico,Spanish,Third,Natural Sciences,Male,the second one (triangular),
58e45c2bd46cc6fa347e5af4,206ZK,experiment,lima,1,axis,longmire,3,6,4,4,0,114073,221715,94052,379532,132615,649378,335788,473584,781993,1904813,5.60,7.89,13.03,31.75,-2.30,9,8,-1,-137796,17,20,USA,English,Second,Social Sciences (incl. CogSci),Female,the first one (linear,
58e45c2bd46cc6fa347e5af5,B23GR,experiment,lima,4,longmire,axis,4,6,3,9,1,122107,395127,155657,300196,202199,605034,517234,455853,807233,2129981,8.62,7.60,13.45,35.50,1.02,10,12,2,61381,23,20,USA,English,Third,Biomedical & Health Sciences,Female,the second one (triangular),
58e45c2bd46cc6fa347e5af6,EU0SL,experiment,lima,3,axis,longmire,5,8,2,2,2,152128,362189,252189,678486,636963,49186,514317,930675,686149,2467801,8.57,15.51,11.44,41.13,-6.94,13,4,-9,-416358,19,20,Korea,Other,Third,Social Sciences (incl. CogSci),Female,the first one (linear,
58e45c2bd46cc6fa347e5af7,R7ORQ,reverse,lima,4,longmire,axis,4,6,3,3,0,96389,294984,145711,251399,164872,522766,391373,397110,687638,1804003,6.52,6.62,11.46,30.07,-0.10,10,6,-4,-5737,16,19,USA,English,First,Social Sciences (incl. CogSci),Female,the first one (linear,
58e45c2bd46cc6fa347e5af8,42RUW,experiment,lima,4,longmire,axis,4,6,2,5,0,105075,452398,268984,527931,38102,625545,557473,796915,663647,2291986,9.29,13.28,11.06,38.20,-3.99,10,7,-3,-239442,17,20,Korea,Other,Second,Fine Arts,Female,the second one (triangular),
58e45c2bd46cc6fa347e5af9,HQRRA,experiment,lima,1,longmire,axis,3,6,1,1,0,336657,985977,311847,679620,389090,84401,1322634,991467,473491,3270982,22.04,16.52,7.89,54.52,5.52,9,2,-7,331167,11,21,USA,English,Third,Social Sciences (incl. CogSci),Female,the first one (linear,
58e45c2bd46cc6fa347e5afa,0MQD4,reverse,lima,1,axis,longmire,4,7,5,9,1,164208,325041,97042,428964,133941,371166,489249,526006,505107,1804001,8.15,8.77,8.42,30.07,-0.61,11,14,3,-36757,26,19,USA,English,Second,Biomedical & Health Sciences,Male,the second one (triangular),
58e45c2bd46cc6fa347e5afb,XJH0T,experiment,lima,3,axis,longmire,3,9,4,8,2,149580,250953,167924,258598,94708,592696,400533,426522,687404,1801278,6.68,7.11,11.46,30.02,-0.43,12,12,0,-25989,26,20,USA,English,Second,Social Sciences (incl. CogSci),Female,the first one (linear,
58e45c2bd46cc6fa347e5afc,452JP,experiment,lima,1,longmire,axis,4,5,1,0,0,285326,447863,163648,501743,482930,199680,733189,665391,682610,2848353,12.22,11.09,11.38,47.47,1.13,9,1,-8,67798,10,19,China,Mandarin or Cantonese,First,Math or Computer Sciences,Female,the first one (linear,
58e45c2bd46cc6fa347e5afd,Z2MDK,experiment,lima,3,axis,longmire,3,9,4,7,1,222875,246556,196825,430994,283887,611849,469431,627819,895736,2338888,7.82,10.46,14.93,38.98,-2.64,12,11,-1,-158388,24,23,USA,English,Fourth,Biomedical & Health Sciences,Male,the first one (linear,
58e45c2bd46cc6fa347e5afe,29438,experiment,lima,3,longmire,axis,4,5,0,0,1,137919,327646,209482,339942,455864,267231,465565,549424,723095,2723828,7.76,9.16,12.05,45.40,-1.40,9,0,-9,-83859,10,18,Nepal ,Other,Second,Biomedical & Health Sciences,Female,the first one (linear,
58e45c2bd46cc6fa347e5aff,N87KU,experiment,lima,1,axis,longmire,5,8,3,6,1,119716,277879,167874,283856,81729,559891,397595,451730,641620,1782282,6.63,7.53,10.69,29.70,-0.90,13,9,-4,-54135,23,19,India,Other,Second,Biomedical & Health Sciences,Male,the second one (triangular),
58e45befd46cc6fa347e5235,4H45F,reverse,november,2,axis,longmire,5,7,4,8,1,174179,391266,273424,422888,83233,1787027,565445,696312,1870260,3455159,9.42,11.61,31.17,57.59,-2.18,12,12,0,-130867,25,21,USA,English,Fourth,Social Sciences (incl. CogSci),Female,the second one (triangular),
58e45befd46cc6fa347e5236,2LN6K,reverse,november,2,longmire,axis,5,8,1,6,2,175200,478438,630386,436175,166347,1197669,653638,1066561,1364016,3430989,10.89,17.78,22.73,57.18,-6.88,13,7,-6,-412923,22,Deja Armstrong,USA,English,First,Biomedical & Health Sciences,Female,the first one (linear,
58e45befd46cc6fa347e5237,PR9HV,experiment,mike,2,axis,longmire,5,4,2,7,1,298105,618511,351794,735665,285114,960641,916616,1087459,1245755,3690372,15.28,18.12,20.76,61.51,-2.85,9,9,0,-170843,19,19,China,Mandarin or Cantonese,First,Social Sciences (incl. CogSci),Female,the first one (linear,
58e45befd46cc6fa347e5238,T82QM,reverse,november,3,axis,longmire,5,9,4,9,2,171725,430790,274763,774115,161258,933430,602515,1048878,1094688,3212119,10.04,17.48,18.24,53.54,-7.44,14,13,-1,-446363,29,22,USA,English,Fourth,Social Sciences (incl. CogSci),Female,the first one (linear,
58e45befd46cc6fa347e5239,M5B60,reverse,mike,4,longmire,axis,5,9,4,8,1,137296,339417,250852,331759,903443,163419,476713,582611,1066862,2511535,7.95,9.71,17.78,41.86,-1.76,14,12,-2,-105898,27,19,USA,English,Second,Social Sciences (incl. CogSci),Other,the second one (triangular),
58e45befd46cc6fa347e523a,BZOAF,reverse,november,2,longmire,axis,4,7,1,0,1,124055,572562,347159,501296,167567,1087232,696617,848455,1254799,3151566,11.61,14.14,20.91,52.53,-2.53,11,1,-10,-151838,13,19,USA,English,Second,Social Sciences (incl. CogSci),Female,the first one (linear,
58e45befd46cc6fa347e523b,R0VCG,reverse,november,3,axis,longmire,3,7,2,0,1,138505,319122,262451,361883,179761,794994,457627,624334,974755,2442081,7.63,10.41,16.25,40.70,-2.78,10,2,-8,-166707,13,20,USA,Other,Third,Social Sciences (incl. CogSci),Female,the second one (triangular),
58e45befd46cc6fa347e523c,HCU65,experiment,november,2,axis,longmire,4,4,5,4,1,267758,348510,327207,436133,192697,472724,616268,763340,665421,2399964,10.27,12.72,11.09,40.00,-2.45,8,9,1,-147072,18,21,India,English,Third,Natural Sciences,Male,the second one (triangular),
58e45befd46cc6fa347e523d,1RRQY,reverse,november,1,axis,longmire,5,9,4,9,2,155708,404697,269919,437092,79382,1465133,560405,707011,1544515,3224513,9.34,11.78,25.74,53.74,-2.44,14,13,-1,-146606,29,18,INDIA,Other,First,Engineering,Female,the second one (triangular),
58e45befd46cc6fa347e523e,FEK1A,reverse,november,2,longmire,axis,5,8,3,8,1,115651,419650,350679,418135,492288,153002,535301,768814,645290,2381243,8.92,12.81,10.75,39.69,-3.89,13,11,-2,-233513,25,23,Korea,Other,Third,Social Sciences (incl. CogSci),Female,the second one (triangular),
58e45befd46cc6fa347e523f,0YCBK,reverse,november,0,longmire,axis,5,7,2,2,2,111881,330465,271716,518114,117241,584869,442346,789830,702110,2312791,7.37,13.16,11.70,38.55,-5.79,12,4,-8,-347484,18,20,Korea,Other,Third,Biomedical & Health Sciences,Female,the first one (linear,
58e45befd46cc6fa347e5240,Y163Y,reverse,november,3,axis,longmire,5,7,5,9,2,147674,355730,169513,420453,122466,587880,503404,589966,710346,2322299,8.39,9.83,11.84,38.70,-1.44,12,14,2,-86562,28,21,China,Mandarin or Cantonese,Third,Natural Sciences,Male,the second one (triangular),
58e45befd46cc6fa347e5241,2G6DZ,reverse,november,2,axis,longmire,4,6,4,8,2,129293,284502,264132,302969,109471,718112,413795,567101,827583,2147696,6.90,9.45,13.79,35.79,-2.56,10,12,2,-153306,24,19,USA,English,First,Social Sciences (incl. CogSci),Female,the first one (linear,
58e45befd46cc6fa347e5242,5HJKF,experiment,november,0,axis,longmire,3,5,2,1,2,96851,262370,75690,238164,164224,374080,359221,313854,538304,1583562,5.99,5.23,8.97,26.39,0.76,8,3,-5,45367,13,18,India,Other,Second,Social Sciences (incl. CogSci),Male,the first one (linear,
58e45befd46cc6fa347e5243,WXTMW,reverse,mike,3,longmire,axis,4,8,3,5,1,127446,491709,249524,440329,1496901,141684,619155,689853,1638585,3685510,10.32,11.50,27.31,61.43,-1.18,12,8,-4,-70698,21,1984,USA,English,Third,Social Sciences (incl. CogSci),Male,the first one (linear,
58e45befd46cc6fa347e5244,0VL0U,reverse,november,3,axis,longmire,4,9,5,8,2,134331,290760,193852,420158,154920,455927,425091,614010,610847,1904601,7.08,10.23,10.18,31.74,-3.15,13,13,0,-188919,28,22,Korea,Other,Fourth,Biomedical & Health Sciences,Female,the first one (linear,
58e45befd46cc6fa347e5245,RSWNL,reverse,november,3,axis,longmire,4,9,2,2,1,100592,221268,164027,450716,77566,532462,321860,614743,610028,1784647,5.36,10.25,10.17,29.74,-4.88,13,4,-9,-292883,18,21,Mongolia,Other,Third,Social Sciences (incl. CogSci),Male,the second one (triangular),
58e45befd46cc6fa347e5246,7ED8L,reverse,november,2,longmire,axis,4,6,1,0,0,153877,556022,510719,689648,57311,1006224,709899,1200367,1063535,3369711,11.83,20.01,17.73,56.16,-8.17,10,1,-9,-490468,11,26,Thailand,English,Fifth,Social Sciences (incl. CogSci),Male,the first one (linear,
58e45befd46cc6fa347e5247,UO2T6,reverse,november,2,longmire,axis,5,9,3,9,2,149418,521625,253309,389168,84222,1161083,671043,642477,1245305,3051312,11.18,10.71,20.76,50.86,0.48,14,12,-2,28566,28,19,USA,Other,Second,Biomedical & Health Sciences,Male,the second one (triangular),
58e45befd46cc6fa347e5248,NNQMR,reverse,mike,0,axis,longmire,5,4,2,3,1,142992,325272,187185,604072,167217,634006,468264,791257,801223,2475607,7.80,13.19,13.35,41.26,-5.38,9,5,-4,-322993,15,25,Sri Lanka,Other,Fourth,Social Sciences (incl. CogSci),Male,the second one (triangular),
58e45befd46cc6fa347e5249,UBU1J,reverse,mike,3,axis,longmire,5,7,2,2,2,169202,345360,236272,1034521,152454,1132991,514562,1270793,1285445,3566683,8.58,21.18,21.42,59.44,-12.60,12,4,-8,-756231,18,20,China,Mandarin or Cantonese,Second,Biomedical & Health Sciences,Female,the first one (linear,
58e45befd46cc6fa347e524a,WRSTF,reverse,november,3,axis,longmire,4,6,2,3,2,150486,369224,219406,1009156,226209,1140951,519710,1228562,1367160,3418310,8.66,20.48,22.79,56.97,-11.81,10,5,-5,-708852,17,18,USA,Spanish,First,Engineering,Male,the second one (triangular),
58e45befd46cc6fa347e524b,AJO2K,reverse,mike,4,axis,longmire,4,6,5,6,2,107368,279402,171880,497897,213812,1211346,386770,669777,1425158,2840748,6.45,11.16,23.75,47.35,-4.72,10,11,1,-283007,23,20,England,English,Third,Social Sciences (incl. CogSci),Female,the second one (triangular),
58e45befd46cc6fa347e524c,SM3FW,reverse,november,1,longmire,axis,5,7,4,9,1,198323,545884,286677,742915,654876,313165,744207,1029592,968041,3149783,12.40,17.16,16.13,52.50,-4.76,12,13,1,-285385,26,20,USA,English,Third,Math or Computer Sciences,Male,the second one (triangular),
58e45befd46cc6fa347e524d,XN2WE,reverse,mike,1,longmire,axis,5,8,4,8,1,164653,586120,323420,408704,812004,68020,750773,732124,880024,2880295,12.51,12.20,14.67,48.00,0.31,13,12,-1,18649,26,20,China,Mandarin or Cantonese,Second,Biomedical & Health Sciences,Male,the second one (triangular),
58e45befd46cc6fa347e524e,WMC7L,reverse,mike,0,axis,longmire,5,8,2,3,2,119416,312408,213442,651289,142096,528567,431824,864731,670663,2532064,7.20,14.41,11.18,42.20,-7.22,13,5,-8,-432907,20,21,USA,English,Fourth,Social Sciences (incl. CogSci),Female,the first one (linear,
58e45befd46cc6fa347e524f,14F0J,reverse,mike,0,axis,longmire,5,9,4,9,1,184537,525564,203201,538494,115672,836962,710101,741695,952634,2836944,11.84,12.36,15.88,47.28,-0.53,14,13,-1,-31594,28,21,USA,English,Fourth,Social Sciences (incl. CogSci),Female,the second one (triangular),
58e45befd46cc6fa347e5250,80TJK,reverse,november,1,axis,longmire,5,8,3,7,2,161811,463014,314205,681414,167612,474415,624825,995619,642027,2671403,10.41,16.59,10.70,44.52,-6.18,13,10,-3,-370794,25,19,USA,English,First,Social Sciences (incl. CogSci),Female,the first one (linear,
58e45befd46cc6fa347e5251,E43B1,experiment,mike,0,axis,longmire,3,9,5,7,0,227606,537096,195974,597223,230819,877196,764702,793197,1108015,3214042,12.75,13.22,18.47,53.57,-0.47,12,12,0,-28495,24,21,USA,Spanish,Fourth,Social Sciences (incl. CogSci),Male,the first one (linear,
58e45befd46cc6fa347e5252,YJRLT,experiment,mike,0,longmire,axis,5,8,1,1,1,109426,396600,312848,437067,72347,848203,506026,749915,920550,2586487,8.43,12.50,15.34,43.11,-4.06,13,2,-11,-243889,16,19,USA,English,Second,Social Sciences (incl. CogSci),Male,the first one (linear,
58e45befd46cc6fa347e5253,9SXEO,experiment,mike,1,longmire,axis,5,8,3,7,2,215983,449087,342013,346680,344348,1175685,665070,688693,1520033,3315073,11.08,11.48,25.33,55.25,-0.39,13,10,-3,-23623,25,19,Dominican Republic,Mandarin or Cantonese,First,Biomedical & Health Sciences,Female,the first one (linear,
58e45befd46cc6fa347e5254,6SESR,reverse,mike,1,axis,longmire,5,8,4,7,2,128364,334329,193805,441002,98961,919362,462693,634807,1018323,2543558,7.71,10.58,16.97,42.39,-2.87,13,11,-2,-172114,26,20,USA,English,Third,Biomedical & Health Sciences,Female,the second one (triangular),
58e45befd46cc6fa347e5255,GP70L,experiment,mike,2,axis,longmire,3,8,3,8,2,131387,244291,167022,393453,282068,281475,375678,560475,563543,1951516,6.26,9.34,9.39,32.53,-3.08,11,11,0,-184797,24,19,USA,English,Second,Math or Computer Sciences,Male,the second one (triangular),
58e45befd46cc6fa347e5256,WN45J,reverse,mike,2,longmire,axis,4,10,4,9,2,110068,428614,214966,422818,94820,787377,538682,637784,882197,2587137,8.98,10.63,14.70,43.12,-1.65,14,13,-1,-99102,29,20,China,Mandarin or Cantonese,First,Math or Computer Sciences,Male,the second one (triangular),
58e45befd46cc6fa347e5257,DB8P9,reverse,mike,2,longmire,axis,4,9,3,8,1,123366,365533,259937,304442,119053,795118,488899,564379,914171,2392044,8.15,9.41,15.24,39.87,-1.26,13,11,-2,-75480,25,27,USA,English,Third,Social Sciences (incl. CogSci),Female,the first one (linear,
58e45befd46cc6fa347e5258,NTST8,reverse,mike,1,axis,longmire,5,7,2,6,0,141351,347186,195769,533071,175861,400426,488537,728840,576287,2204169,8.14,12.15,9.60,36.74,-4.01,12,8,-4,-240303,20,21,USA,Spanish,Fourth,Social Sciences (incl. CogSci),Male,the first one (linear,
58e45befd46cc6fa347e5259,YH6KW,reverse,november,2,axis,longmire,4,7,5,10,2,204679,408632,239968,531573,135160,712459,613311,771541,847619,2646096,10.22,12.86,14.13,44.10,-2.64,11,15,4,-158230,28,18,China,Mandarin or Cantonese,First,Biomedical & Health Sciences,Female,the first one (linear,
58e45befd46cc6fa347e525a,18MDU,reverse,mike,4,longmire,axis,4,9,3,7,1,111682,448309,194760,365850,145057,475250,559991,560610,620307,2188536,9.33,9.34,10.34,36.48,-0.01,13,10,-3,-619,24,19,USA,Spanish,First,Fine Arts,Female,the first one (linear,
58e45befd46cc6fa347e525b,GQN1V,reverse,mike,3,axis,longmire,4,6,5,8,1,153596,333974,273240,458296,127392,410063,487570,731536,537455,2138235,8.13,12.19,8.96,35.64,-4.07,10,13,3,-243966,24,18,Thailand,English,First,Natural Sciences,Female,the first one (linear,
58e45befd46cc6fa347e525c,EKNO2,reverse,november,2,axis,longmire,4,10,3,9,2,119162,185967,235376,224068,103317,451205,305129,459444,554522,1591772,5.09,7.66,9.24,26.53,-2.57,14,12,-2,-154315,28,19,USA,English,Second,Biomedical & Health Sciences,Female,the first one (linear,
58e45befd46cc6fa347e525d,88WRE,reverse,mike,0,axis,longmire,4,6,1,1,1,135724,298553,195712,597422,731139,69918,434277,793134,801057,2527063,7.24,13.22,13.35,42.12,-5.98,10,2,-8,-358857,13,18,INDIA,Other,First,Math or Computer Sciences,Male,the second one (triangular),
58e45befd46cc6fa347e525e,7L5E7,reverse,mike,0,axis,longmire,5,7,5,9,2,118401,289762,210797,386476,103007,445660,408163,597273,548667,2038959,6.80,9.95,9.14,33.98,-3.15,12,14,2,-189110,28,20,China,Mandarin or Cantonese,Second,Math or Computer Sciences,Male,the second one (triangular),
58e45befd46cc6fa347e525f,G7PG5,reverse,mike,0,axis,longmire,3,5,5,7,1,117516,456260,261151,474535,161009,362547,573776,735686,523556,2278848,9.56,12.26,8.73,37.98,-2.70,8,12,4,-161910,21,21,USA,Spanish,Fourth,Social Sciences (incl. CogSci),Female,the second one (triangular),
58e45befd46cc6fa347e5260,VVNY9,reverse,mike,4,longmire,axis,4,8,4,10,2,78425,428092,110742,221747,72387,583314,506517,332489,655701,2010913,8.44,5.54,10.93,33.52,2.90,12,14,2,174028,28,21,Colombia,Spanish,Third,Social Sciences (incl. CogSci),Female,the second one (triangular),
58e45befd46cc6fa347e5261,6Y878,reverse,mike,1,longmire,axis,4,4,0,0,1,116572,161067,200148,345763,369986,62459,277639,545911,432445,1647305,4.63,9.10,7.21,27.46,-4.47,8,0,-8,-268272,9,18,USA,English,First,Biomedical & Health Sciences,Female,the first one (linear,
58e45befd46cc6fa347e5262,P307J,reverse,mike,1,longmire,axis,4,7,2,7,0,178978,580734,667514,483595,143577,879972,759712,1151109,1023549,3364638,12.66,19.19,17.06,56.08,-6.52,11,9,-2,-391397,20,19,USA,Spanish,First,Biomedical & Health Sciences,Male,the first one (linear,
58e45befd46cc6fa347e5263,AHBJE,reverse,mike,4,longmire,axis,3,7,3,6,1,89023,370534,124537,274288,73161,793097,459557,398825,866258,2161173,7.66,6.65,14.44,36.02,1.01,10,9,-1,60732,20,20,USA,English,Third,Biomedical & Health Sciences,Male,the second one (triangular),
58e45befd46cc6fa347e5264,59BNT,experiment,mike,2,axis,longmire,3,9,5,9,2,159846,302849,254973,408967,123515,890651,462695,663940,1014166,2548463,7.71,11.07,16.90,42.47,-3.35,12,14,2,-201245,28,20,USA,English,Second,Social Sciences (incl. CogSci),Male,the first one (linear,
"ObjectId(""58ffef548c1cc23bab096a24"")",1J0CV,experiment,expert,e4,longmire,axis,5,10,5,10,2,181298,539140,181467,347357,41727,281441,720438,528824,323168,1678129,12.01,8.81,5.39,27.97,3.19,15,15,0,191614,32,22,Taiwan},Mandarin or Cantonese,Fourth,Social Sciences (incl. CogSci),Female,the second one (triangular)},KAI
"ObjectId(""58ffef548c1cc23bab096a25"")",V7F3B,experiment,expert,e4,axis,longmire,5,7,5,7,2,147755,397317,114890,352570,34142,327791,545072,467460,361933,1480664,9.08,7.79,6.03,24.68,1.29,12,12,0,77612,26,20,USA},English,Third,Social Sciences (incl. CogSci),Female,the second one (triangular)},EVAN
"ObjectId(""58ffef548c1cc23bab096a26"")",NOS98,experiment,expert,e4,longmire,axis,3,8,5,8,2,158954,535111,132943,337370,11187,457740,694065,470313,468927,1777666,11.57,7.84,7.82,29.63,3.73,11,13,2,223752,26,20,USA},Mandarin or Cantonese,Second,Social Sciences (incl. CogSci),Female,the second one (triangular)},HAZEL
"ObjectId(""58ffef548c1cc23bab096a27"")",KUPVH,experiment,expert,e0,axis,longmire,4,6,5,6,2,217116,554872,129699,624081,98578,665210,771988,753780,763788,2798663,12.87,12.56,12.73,46.64,0.30,10,11,1,18208,23,20,USA},English,Third,Social Sciences (incl. CogSci),Female,the second one (triangular)},EVAN
"ObjectId(""58ffef548c1cc23bab096a28"")",Y07OR,experiment,expert,e0,axis,longmire,4,4,5,7,2,120068,251114,102579,369531,80910,525944,371182,472110,606854,1759115,6.19,7.87,10.11,29.32,-1.68,8,12,4,-100928,22,20,USA},Mandarin or Cantonese,Second,Social Sciences (incl. CogSci),Female,the second one (triangular)},HAZEL
"ObjectId(""58ffef548c1cc23bab096a29"")",8XZ5Z,experiment,expert,e0,axis,longmire,5,10,5,10,2,208124,546168,152859,579118,124029,506847,754292,731977,630876,2302199,12.57,12.20,10.51,38.37,0.37,15,15,0,22315,32,22,Taiwan},Mandarin or Cantonese,Fourth,Social Sciences (incl. CogSci),Female,the second one (triangular)},KAI