"_id","experiment","session","condition","lm_scenarios","tm_scenarios","ls_n","lt_n","ts_n","tt_n","d_n","ls_t","lt_t","ts_t","tt_t","d_t","draw_t","totalTime","subject","linear_score","triangular_score","linear_time","triangular_time","score_diff","time_diff","totalScore","demo1","demo2"
"ObjectId(""58e45f47d46cc6fa347ea5d2"")","experiment","bravo","3","longmire","axis","4","5","2","6","1","133750","894922","242399","458259","135794","883766","3059086","0UUFC","9","8","1028672","700658","-1","328014","18","{""Q0"":""English"",""Q1"":""Second"",""Q2"":""Social Sciences (incl. CogSci)"",""Q3"":""Female"",""Q4"":""the first one (linear""}","{""Q0"":""19"",""Q1"":""united states""}"
"ObjectId(""58e45f47d46cc6fa347ea5d3"")","reverse","bravo","4","longmire","axis","4","8","2","7","0","197706","596759","202481","476227","334796","396918","2644837","3FDVP","12","9","794465","678708","-3","115757","21","{""Q0"":""Spanish"",""Q1"":""Third"",""Q2"":""Humanities"",""Q3"":""Female"",""Q4"":""the second one (triangular)""}","{""Q0"":""20"",""Q1"":""Mexico""}"
"ObjectId(""58e45f47d46cc6fa347ea5d4"")","experiment","bravo","2","axis","longmire","5","8","5","9","2","232809","383135","268736","479839","203246","608330","2515649","ZNUEO","13","14","615944","748575","1","-132631","29","{""Q0"":""English"",""Q1"":""Fifth"",""Q2"":""Natural Sciences"",""Q3"":""Male"",""Q4"":""the first one (linear""}","{""Q0"":""22"",""Q1"":""USA""}"
"ObjectId(""58e45f47d46cc6fa347ea5d5"")","experiment","bravo","2","axis","longmire","3","7","2","5","2","244860","321167","253429","370941","113733","726536","2492380","5ZV2X","10","7","566027","624370","-3","-58343","19","{""Q0"":""Spanish"",""Q1"":""Third"",""Q2"":""Biomedical & Health Sciences"",""Q3"":""Female"",""Q4"":""the second one (triangular)""}","{""Q0"":""20"",""Q1"":""usa""}"
"ObjectId(""58e45f47d46cc6fa347ea5d6"")","experiment","bravo","3","axis","longmire","2","2","3","2","2","136471","117408","125942","224296","86567","326123","1528455","1129F","4","5","253879","350238","1","-96359","11","{""Q0"":""English"",""Q1"":""Fourth"",""Q2"":""Biomedical & Health Sciences"",""Q3"":""Female"",""Q4"":""the first one (linear""}","{""Q0"":""21"",""Q1"":""China""}"
"ObjectId(""58e45f47d46cc6fa347ea5d7"")","reverse","bravo","4","axis","longmire","5","7","5","9","2","180266","378557","159493","621545","123174","487564","2456733","8BN4N","12","14","558823","781038","2","-222215","28","{""Q0"":""Other"",""Q1"":""Second"",""Q2"":""Social Sciences (incl. CogSci)"",""Q3"":""Female"",""Q4"":""the first one (linear""}","{""Q0"":""20"",""Q1"":""Bulgaria""}"
"ObjectId(""58e45f47d46cc6fa347ea5d8"")","experiment","bravo","4","longmire","axis","4","6","3","9","2","133769","442125","229269","311451","143956","381497","2116908","OA5JN","10","12","575894","540720","2","35174","24","{""Q0"":""English"",""Q1"":""Fourth"",""Q2"":""Natural Sciences"",""Q3"":""Male"",""Q4"":""the second one (triangular)""}","{""Q0"":""21"",""Q1"":""USA""}"
"ObjectId(""58e45f47d46cc6fa347ea5d9"")","reverse","bravo","2","axis","longmire","4","9","5","10","2","126575","328198","153803","358266","77358","837294","2223070","JYJXS","13","15","454773","512069","2","-57296","30","{""Q0"":""Other"",""Q1"":""Third"",""Q2"":""Biomedical & Health Sciences"",""Q3"":""Female"",""Q4"":""the second one (triangular)""}","{""Q0"":""22"",""Q1"":""usa""}"
"ObjectId(""58e45f47d46cc6fa347ea5da"")","reverse","bravo","3","axis","longmire","4","7","2","7","1","167692","405082","114181","509789","268064","771629","2609087","76WFU","11","9","572774","623970","-2","-51196","21","{""Q0"":""English"",""Q1"":""Fourth"",""Q2"":""Social Sciences (incl. CogSci)"",""Q3"":""Female"",""Q4"":""the first one (linear""}","{""Q0"":""24"",""Q1"":""USA""}"
"ObjectId(""58e45f47d46cc6fa347ea5db"")","reverse","bravo","2","longmire","axis","5","8","3","7","1","135563","268022","342299","401234","144809","532121","2508585","N5CZB","13","10","403585","743533","-3","-339948","24","{""Q0"":""Mandarin or Cantonese"",""Q1"":""Third"",""Q2"":""Social Sciences (incl. CogSci)"",""Q3"":""Male"",""Q4"":""the first one (linear""}","{""Q0"":""21"",""Q1"":""China""}"
"ObjectId(""58e45f47d46cc6fa347ea5dc"")","reverse","bravo","2","axis","longmire","5","8","4","7","2","174007","467129","261624","581978","207667","735438","3082170","FSJAY","13","11","641136","843602","-2","-202466","26","{""Q0"":""English"",""Q1"":""Fourth"",""Q2"":""Math or Computer Sciences"",""Q3"":""Male"",""Q4"":""the first one (linear""}","{""Q0"":""22"",""Q1"":""USA""}"
"ObjectId(""58e45f47d46cc6fa347ea5dd"")","reverse","Bravo","4","longmire","axis","4","4","3","6","1","93085","324819","206278","333625","732820","144397","2379389","XDT95","8","9","417904","539903","1","-121999","18","{""Q0"":""Spanish"",""Q1"":""Fourth"",""Q2"":""Biomedical & Health Sciences"",""Q3"":""Female"",""Q4"":""the second one (triangular)""}","{""Q0"":""22"",""Q1"":""United States""}"
"ObjectId(""58e45f47d46cc6fa347ea5de"")","experiment","bravo","2","longmire","axis","4","4","1","0","0","125323","424809","145575","164426","23756","468314","1732827","A5G40","8","1","550132","310001","-7","240131","9","{""Q0"":""Mandarin or Cantonese"",""Q1"":""Fourth"",""Q2"":""Social Sciences (incl. CogSci)"",""Q3"":""Male"",""Q4"":""the first one (linear""}","{""Q0"":""21"",""Q1"":""Hong Kong""}"
"ObjectId(""58e45f47d46cc6fa347ea5df"")","experiment","bravo","2","longmire","axis","3","7","3","8","2","128517","433704","179384","323797","117300","889754","2356673","9T9QO","10","11","562221","503181","1","59040","23","{""Q0"":""English"",""Q1"":""Fourth"",""Q2"":""Social Sciences (incl. CogSci)"",""Q3"":""Female"",""Q4"":""the first one (linear""}","{""Q0"":""21"",""Q1"":""USA""}"
"ObjectId(""58e45f47d46cc6fa347ea5e0"")","experiment","bravo","4","longmire","axis","1","4","2","2","0","175773","404722","86533","174383","66724","430818","1638724","XDJJL","5","4","580495","260916","-1","319579","9","{""Q0"":""Spanish"",""Q1"":""Fourth"",""Q2"":""Humanities"",""Q3"":""Male"",""Q4"":""the second one (triangular)""}","{""Q0"":""22"",""Q1"":""usa""}"
"ObjectId(""58e45f47d46cc6fa347ea5e1"")","reverse","bravo","2","axis","longmire","5","6","5","5","1","150918","320738","203809","527189","185422","979986","2660271","CHZCL","11","10","471656","730998","-1","-259342","22","{""Q0"":""English"",""Q1"":""First"",""Q2"":""Biomedical & Health Sciences"",""Q3"":""Female"",""Q4"":""the first one (linear""}","{""Q0"":""18"",""Q1"":""United States""}"
"ObjectId(""58e45f47d46cc6fa347ea5e2"")","experiment","bravo","3","axis","longmire","4","5","5","8","2","132471","364354","177567","281978","84654","591395","1923215","AUN52","9","13","496825","459545","4","37280","24","{""Q0"":""Mandarin or Cantonese"",""Q1"":""Fourth"",""Q2"":""Social Sciences (incl. CogSci)"",""Q3"":""Female"",""Q4"":""the first one (linear""}","{""Q0"":""21"",""Q1"":""China""}"
"ObjectId(""58e45f47d46cc6fa347ea5e3"")","reverse","bravo","0","longmire","axis","5","9","2","7","1","122060","387635","400212","675529","109302","740048","2849603","Q3HE8","14","9","509695","1075741","-5","-566046","24","{""Q0"":""Mandarin or Cantonese"",""Q1"":""Fourth"",""Q2"":""Biomedical & Health Sciences"",""Q3"":""Female"",""Q4"":""the first one (linear""}","{""Q0"":""22"",""Q1"":""China""}"
"ObjectId(""58e45f47d46cc6fa347ea5e4"")","reverse","bravo","4","longmire","axis","4","5","2","6","0","180853","419872","240103","396366","100835","740646","2632421","DSG2T","9","8","600725","636469","-1","-35744","17","{""Q0"":""English"",""Q1"":""Fourth"",""Q2"":""Social Sciences (incl. CogSci)"",""Q3"":""Female"",""Q4"":""the second one (triangular)""}","{""Q0"":""25"",""Q1"":""US""}"
"ObjectId(""58e45f47d46cc6fa347ea5e5"")","experiment","bravo","0","longmire","axis","3","7","1","0","1","129790","601412","255442","336158","166200","542180","2328840","TGAU4","10","1","731202","591600","-9","139602","12","{""Q0"":""Spanish"",""Q1"":""Fourth"",""Q2"":""Math or Computer Sciences"",""Q3"":""Female"",""Q4"":""the first one (linear""}","{""Q0"":""21"",""Q1"":""US""}"
"ObjectId(""58e45f47d46cc6fa347ea5e6"")","reverse","bravo","3","longmire","axis","3","4","3","5","0","111740","382926","196377","323742","59206","503196","1813759","Y7TQD","7","8","494666","520119","1","-25453","15","{""Q0"":""English"",""Q1"":""Third"",""Q2"":""Biomedical & Health Sciences"",""Q3"":""Female"",""Q4"":""the second one (triangular)""}","{""Q0"":""19"",""Q1"":""usa""}"
"ObjectId(""58e45f47d46cc6fa347ea5e7"")","experiment","bravo","4","axis","longmire","3","2","0","0","1","105476","141370","47724","94399","31371","683764","1630483","K2EGE","5","0","246846","142123","-5","104723","6","{""Q0"":""Spanish"",""Q1"":""First"",""Q2"":""Biomedical & Health Sciences"",""Q3"":""Female"",""Q4"":""the first one (linear""}","{""Q0"":""18"",""Q1"":""usa""}"
"ObjectId(""58e45f47d46cc6fa347ea5e8"")","reverse","bravo","3","longmire","axis","4","8","2","5","1","144126","360669","164853","316564","519001","131484","2033550","WYGTA","12","7","504795","481417","-5","23378","20","{""Q0"":""English"",""Q1"":""Third"",""Q2"":""Social Sciences (incl. CogSci)"",""Q3"":""Female"",""Q4"":""the first one (linear""}","{""Q0"":""21"",""Q1"":""U.S.""}"
"ObjectId(""58e45f47d46cc6fa347ea5e9"")","reverse","bravo","2","axis","longmire","5","9","4","7","1","132153","289693","237219","405558","312313","789486","2458631","1592P","14","11","421846","642777","-3","-220931","26","{""Q0"":""Mandarin or Cantonese"",""Q1"":""First"",""Q2"":""Math or Computer Sciences"",""Q3"":""Female"",""Q4"":""the second one (triangular)""}","{""Q0"":""19"",""Q1"":""China""}"
