"_id","experiment","session","condition","lm_scenarios","tm_scenarios","ls_n","lt_n","ts_n","tt_n","d_n","ls_t","lt_t","ts_t","tt_t","d_t","draw_t","totalTime","subject","linear_score","triangular_score","linear_time","triangular_time","score_diff","time_diff","totalScore","demo1","demo2"
"ObjectId(""58e45e33d46cc6fa347e9060"")","reverse","echo","3","longmire","axis","4","5","3","5","1","108664","428249","221475","424155","899807","106994","2385396","TA2L5","9","8","536913","645630","-1","-108717","18","{""Q0"":""English"",""Q1"":""Fourth"",""Q2"":""Social Sciences (incl. CogSci)"",""Q3"":""Male"",""Q4"":""the first one (linear""}","{""Q0"":""21"",""Q1"":""US""}"
"ObjectId(""58e45e33d46cc6fa347e9061"")","reverse","echo","3","longmire","axis","4","6","1","1","0","108371","428223","166751","506336","104932","872878","2377342","UOBPQ","10","2","536594","673087","-8","-136493","12","{""Q0"":""Spanish"",""Q1"":""Fifth"",""Q2"":""Natural Sciences"",""Q3"":""Female"",""Q4"":""the first one (linear""}","{""Q0"":""24"",""Q1"":""mEXICO""}"
"ObjectId(""58e45e33d46cc6fa347e9062"")","reverse","echo","0","longmire","axis","4","8","1","5","2","132110","407387","258584","518476","147056","622498","2239647","POQNH","12","6","539497","777060","-6","-237563","20","{""Q0"":""Other"",""Q1"":""Fourth"",""Q2"":""Social Sciences (incl. CogSci)"",""Q3"":""Female"",""Q4"":""the first one (linear""}","{""Q0"":""21"",""Q1"":""United States""}"
"ObjectId(""58e45e33d46cc6fa347e9063"")","reverse","echo","2","axis","longmire","4","3","2","2","1","163910","356553","337470","603253","597115","118215","2363125","W12ZU","7","4","520463","940723","-3","-420260","12","{""Q0"":""English"",""Q1"":""Fourth"",""Q2"":""Biomedical & Health Sciences"",""Q3"":""Female"",""Q4"":""the first one (linear""}","{""Q0"":""21"",""Q1"":""united states""}"
"ObjectId(""58e45e33d46cc6fa347e9064"")","reverse","echo","2","longmire","axis","5","6","1","0","1","139084","446429","176348","379811","364934","642988","2340290","FTX1J","11","1","585513","556159","-10","29354","13","{""Q0"":""Mandarin or Cantonese"",""Q1"":""Fourth"",""Q2"":""Social Sciences (incl. CogSci)"",""Q3"":""Female"",""Q4"":""the second one (triangular)""}","{""Q0"":""21"",""Q1"":""Hong Kong""}"
"ObjectId(""58e45e33d46cc6fa347e9065"")","reverse","echo","3","axis","longmire","4","9","5","8","2","161088","321633","140279","411771","156240","765612","2223797","UUTZ9","13","13","482721","552050","0","-69329","28","{""Q0"":""Mandarin or Cantonese"",""Q1"":""First"",""Q2"":""Engineering"",""Q3"":""Male"",""Q4"":""the second one (triangular)""}","{""Q0"":""18"",""Q1"":""USA""}"
"ObjectId(""58e45e33d46cc6fa347e9066"")","reverse","echo","4","longmire","axis","4","5","1","0","1","137955","358705","405651","598965","165208","626354","2502554","AYPYF","9","1","496660","1004616","-8","-507956","11","{""Q0"":""English"",""Q1"":""Second"",""Q2"":""Math or Computer Sciences"",""Q3"":""Male"",""Q4"":""the first one (linear""}","{""Q0"":""20"",""Q1"":""United States of America""}"
"ObjectId(""58e45e33d46cc6fa347e9067"")","reverse","echo","2","axis","longmire","4","8","1","5","2","107661","287586","215480","671074","104298","610540","2203064","UNUPL","12","6","395247","886554","-6","-491307","20","{""Q0"":""Mandarin or Cantonese"",""Q1"":""Second"",""Q2"":""Biomedical & Health Sciences"",""Q3"":""Male"",""Q4"":""the first one (linear""}","{""Q0"":""20"",""Q1"":""Taiwan""}"
"ObjectId(""58e45e33d46cc6fa347e9068"")","reverse","echo","0","longmire","axis","5","7","4","8","2","114668","415326","216733","328340","636496","152369","2113749","RGOP0","12","12","529994","545073","0","-15079","26","{""Q0"":""English"",""Q1"":""First"",""Q2"":""Engineering"",""Q3"":""Female"",""Q4"":""the second one (triangular)""}","{""Q0"":""19"",""Q1"":""USA""}"
"ObjectId(""58e45e33d46cc6fa347e9069"")","reverse","echo","3","longmire","axis","4","7","4","6","2","106617","308157","131163","392302","130290","884390","2127691","78CYG","11","10","414774","523465","-1","-108691","23","{""Q0"":""English"",""Q1"":""Second"",""Q2"":""Social Sciences (incl. CogSci)"",""Q3"":""Female"",""Q4"":""the first one (linear""}","{""Q0"":""19"",""Q1"":""United States of America""}"
"ObjectId(""58e45e33d46cc6fa347e906a"")","experiment","echo","4","axis","longmire","3","5","4","7","2","159028","331220","134985","443985","566574","104189","1946437","WMNAY","8","11","490248","578970","3","-88722","21","{""Q0"":""Mandarin or Cantonese"",""Q1"":""First"",""Q2"":""Social Sciences (incl. CogSci)"",""Q3"":""Female"",""Q4"":""the second one (triangular)""}","{""Q0"":""22"",""Q1"":""China""}"
"ObjectId(""58e45e33d46cc6fa347e906b"")","experiment","echo","2","axis","longmire","4","9","4","10","2","141790","494496","186568","363475","128028","561211","2564704","2JSK2","13","14","636286","550043","1","86243","29","{""Q0"":""Other"",""Q1"":""Third"",""Q2"":""Math or Computer Sciences"",""Q3"":""Male"",""Q4"":""the second one (triangular)""}","{""Q0"":""20"",""Q1"":""Brazil""}"
"ObjectId(""58e45e33d46cc6fa347e906c"")","reverse","echo","4","axis","longmire","4","5","3","8","1","144957","313118","129106","461287","115309","621860","2045305","Z65A1","9","11","458075","590393","2","-132318","21","{""Q0"":""Other"",""Q1"":""Third"",""Q2"":""Social Sciences (incl. CogSci)"",""Q3"":""Female"",""Q4"":""the second one (triangular)""}","{""Q0"":""20"",""Q1"":""United States""}"
"ObjectId(""58e45e33d46cc6fa347e906d"")","reverse","echo","4","longmire","axis","5","8","1","0","2","98111","344385","325172","411145","112472","516238","2050708","WM4OX","13","1","442496","736317","-12","-293821","16","{""Q0"":""English"",""Q1"":""Second"",""Q2"":""Social Sciences (incl. CogSci)"",""Q3"":""Male"",""Q4"":""the first one (linear""}","{""Q0"":""20"",""Q1"":""US""}"
"ObjectId(""58e45e33d46cc6fa347e906e"")","reverse","echo","4","longmire","axis","4","3","0","3","0","93422","338099","112987","161733","835691","75820","1740197","9YM1Z","7","3","431521","274720","-4","156801","10","{""Q0"":""English"",""Q1"":""Fourth"",""Q2"":""Biomedical & Health Sciences"",""Q3"":""Female"",""Q4"":""the first one (linear""}","{""Q0"":""21"",""Q1"":""us""}"
"ObjectId(""58e45e33d46cc6fa347e906f"")","reverse","bravo","3","longmire","axis","5","5","2","4","0","136358","353993","379281","446215","102961","322544","1889229","OOSCB","10","6","490351","825496","-4","-335145","16","{""Q0"":""English"",""Q1"":""Fourth"",""Q2"":""Social Sciences (incl. CogSci)"",""Q3"":""Female"",""Q4"":""the first one (linear""}","{""Q0"":""21"",""Q1"":""United States""}"
"ObjectId(""58e45e33d46cc6fa347e9070"")","reverse","echo","2","longmire","axis","4","4","2","0","1","116934","472023","276084","273019","694101","41730","2017643","0T69Q","8","2","588957","549103","-6","39854","11","{""Q0"":""Other"",""Q1"":""First"",""Q2"":""Math or Computer Sciences"",""Q3"":""Male"",""Q4"":""the first one (linear""}","{""Q0"":""19"",""Q1"":""korea""}"
"ObjectId(""58e45e33d46cc6fa347e9071"")","reverse","echo","2","axis","longmire","5","10","5","7","1","132647","271115","240896","432616","115521","1257100","2963956","0O5R5","15","12","403762","673512","-3","-269750","28","{""Q0"":""English"",""Q1"":""First"",""Q2"":""Social Sciences (incl. CogSci)"",""Q3"":""Female"",""Q4"":""the first one (linear""}","{""Q0"":""18"",""Q1"":""United States""}"
"ObjectId(""58e45e33d46cc6fa347e9072"")","reverse","echo","2","longmire","axis","4","9","2","8","1","91464","296172","263062","222281","179377","563217","1847544","1SZED","13","10","387636","485343","-3","-97707","24","{""Q0"":""English"",""Q1"":""Third"",""Q2"":""Social Sciences (incl. CogSci)"",""Q3"":""Male"",""Q4"":""the first one (linear""}","{""Q0"":""21"",""Q1"":""United States""}"
"ObjectId(""58e45e33d46cc6fa347e9073"")","experiment","echo","0","axis","longmire","5","6","3","3","1","175448","229328","193595","374587","54284","492279","1860234","RE9Z1","11","6","404776","568182","-5","-163406","18","{""Q0"":""English"",""Q1"":""First"",""Q2"":""Humanities"",""Q3"":""Female"",""Q4"":""the first one (linear""}","{""Q0"":""18"",""Q1"":""United States""}"
"ObjectId(""58e45e33d46cc6fa347e9074"")","experiment","echo","2","longmire","axis","3","6","1","0","0","156949","377362","244968","331777","70638","442445","1859069","DJ7X4","9","1","534311","576745","-8","-42434","10","{""Q0"":""English"",""Q1"":""Third"",""Q2"":""Social Sciences (incl. CogSci)"",""Q3"":""Male"",""Q4"":""the first one (linear""}","{""Q0"":""21"",""Q1"":""United States""}"
"ObjectId(""58e45e33d46cc6fa347e9075"")","reverse","echo","3","longmire","axis","5","9","3","8","2","104292","336780","226991","385746","111113","678750","2066367","26O5W","14","11","441072","612737","-3","-171665","27","{""Q0"":""Other"",""Q1"":""Third"",""Q2"":""Social Sciences (incl. CogSci)"",""Q3"":""Female"",""Q4"":""the first one (linear""}","{""Q0"":""23"",""Q1"":""SOUTH KOREA""}"
"ObjectId(""58e45e33d46cc6fa347e9076"")","reverse","echo","4","longmire","axis","5","5","1","1","2","101902","270685","160133","344181","101721","464301","1564066","AX24A","10","2","372587","504314","-8","-131727","14","{""Q0"":""English"",""Q1"":""Fourth"",""Q2"":""Biomedical & Health Sciences"",""Q3"":""Female"",""Q4"":""the first one (linear""}","{""Q0"":""21"",""Q1"":""USA""}"
"ObjectId(""58e45e33d46cc6fa347e9077"")","reverse","echo","2","axis","longmire","5","7","4","6","1","117935","240414","152513","319784","150721","355404","1511963","KV969","12","10","358349","472297","-2","-113948","23","{""Q0"":""English"",""Q1"":""Fifth"",""Q2"":""Social Sciences (incl. CogSci)"",""Q3"":""Female"",""Q4"":""the first one (linear""}","{""Q0"":""22"",""Q1"":""United States of America""}"
