"_id","experiment","session","condition","lm_scenarios","tm_scenarios","ls_n","lt_n","ts_n","tt_n","d_n","ls_t","lt_t","ts_t","tt_t","d_t","draw_t","totalTime","subject","linear_score","triangular_score","linear_time","triangular_time","score_diff","time_diff","totalScore","demo1","demo2"
"ObjectId(""58e45df9d46cc6fa347e88f1"")","reverse","foxtrot","2","axis","longmire","5","4","5","8","1","199882","577400","188808","542450","285286","949852","2956385","QP34G","9","13","777282","731258","4","46024","23","{""Q0"":""Other"",""Q1"":""Fourth"",""Q2"":""Social Sciences (incl. CogSci)"",""Q3"":""Female"",""Q4"":""the second one (triangular)""}","{""Q0"":""20"",""Q1"":""INDONESIA""}"
"ObjectId(""58e45df9d46cc6fa347e88f2"")","experiment","foxtrot","2","longmire","axis","3","7","0","9","2","222758","621305","373252","360655","180922","751329","2998922","NRVM6","10","9","844063","733907","-1","110156","21","{""Q0"":""Mandarin or Cantonese"",""Q1"":""First"",""Q2"":""Social Sciences (incl. CogSci)"",""Q3"":""Female"",""Q4"":""the first one (linear""}","{""Q0"":""19"",""Q1"":""China""}"
"ObjectId(""58e45df9d46cc6fa347e88f3"")","experiment","foxtrot","3","axis","longmire","5","7","5","10","2","214140","481049","173075","388562","299313","1084394","2865357","9CB27","12","15","695189","561637","3","133552","29","{""Q0"":""Spanish"",""Q1"":""First"",""Q2"":""Math or Computer Sciences"",""Q3"":""Male"",""Q4"":""the first one (linear""}","{""Q0"":""18"",""Q1"":""Mexico""}"
"ObjectId(""58e45df9d46cc6fa347e88f4"")","experiment","foxtrot","3","longmire","axis","2","8","1","9","0","149470","816164","274123","453766","1186143","224606","3753889","O4HU0","10","10","965634","727889","0","237745","20","{""Q0"":""Other"",""Q1"":""Third"",""Q2"":""Math or Computer Sciences"",""Q3"":""Female"",""Q4"":""the second one (triangular)""}","{""Q0"":""28"",""Q1"":""Belarus""}"
"ObjectId(""58e45df9d46cc6fa347e88f5"")","experiment","foxtrot","2","longmire","axis","5","8","4","10","2","157034","625152","175590","354951","166457","860270","2722568","LXM5D","13","14","782186","530541","1","251645","29","{""Q0"":""Mandarin or Cantonese"",""Q1"":""Second"",""Q2"":""Social Sciences (incl. CogSci)"",""Q3"":""Female"",""Q4"":""the second one (triangular)""}","{""Q0"":""19"",""Q1"":""China""}"
"ObjectId(""58e45df9d46cc6fa347e88f6"")","reverse","foxtrot","2","longmire","axis","4","6","5","8","0","87437","419564","302754","340350","196397","966667","2648298","CZLGR","10","13","507001","643104","3","-136103","23","{""Q0"":""Mandarin or Cantonese"",""Q1"":""First"",""Q2"":""Social Sciences (incl. CogSci)"",""Q3"":""Female"",""Q4"":""the first one (linear""}","{""Q0"":""18"",""Q1"":""USA""}"
"ObjectId(""58e45df9d46cc6fa347e88f7"")","experiment","foxtrot","2","axis","longmire","2","7","4","6","2","160366","464145","170828","465702","143233","632121","2346793","P3Y2J","9","10","624511","636530","1","-12019","21","{""Q0"":""English"",""Q1"":""First"",""Q2"":""Social Sciences (incl. CogSci)"",""Q3"":""Female"",""Q4"":""the second one (triangular)""}","{""Q0"":""18"",""Q1"":""USA""}"
"ObjectId(""58e45df9d46cc6fa347e88f8"")","experiment","foxtrot","0","longmire","axis","2","5","4","8","0","138908","432540","212666","333309","103747","1235003","2834703","FSTGR","7","12","571448","545975","5","25473","19","{""Q0"":""English"",""Q1"":""First"",""Q2"":""Social Sciences (incl. CogSci)"",""Q3"":""Male"",""Q4"":""the first one (linear""}","{""Q0"":""18"",""Q1"":""United States Of America""}"
"ObjectId(""58e45df9d46cc6fa347e88f9"")","reverse","foxtrot","3","axis","longmire","4","7","2","5","2","161793","475703","158667","520995","223830","684386","2469146","UPEEJ","11","7","637496","679662","-4","-42166","20","{""Q0"":""English"",""Q1"":""Third"",""Q2"":""Social Sciences (incl. CogSci)"",""Q3"":""Female"",""Q4"":""the second one (triangular)""}","{""Q0"":""25"",""Q1"":""USA""}"
"ObjectId(""58e45df9d46cc6fa347e88fa"")","experiment","foxtrot","0","longmire","axis","4","5","1","1","0","185010","454757","329355","371944","58596","1058021","2787107","90L9R","9","2","639767","701299","-7","-61532","11","{""Q0"":""English"",""Q1"":""Fourth"",""Q2"":""Social Sciences (incl. CogSci)"",""Q3"":""Female"",""Q4"":""the first one (linear""}","{""Q0"":""22"",""Q1"":""United States""}"
"ObjectId(""58e45df9d46cc6fa347e88fb"")","experiment","foxtrot","3","axis","longmire","5","8","2","9","2","175115","480923","167867","513287","192997","470979","2402300","5EC34","13","11","656038","681154","-2","-25116","26","{""Q0"":""English"",""Q1"":""Fourth"",""Q2"":""Social Sciences (incl. CogSci)"",""Q3"":""Female"",""Q4"":""the first one (linear""}","{""Q0"":""21"",""Q1"":""United States""}"
"ObjectId(""58e45df9d46cc6fa347e88fc"")","reverse","foxtrot","0","axis","longmire","4","4","3","6","0","180765","361452","163088","459446","794759","201719","2294960","BZ88S","8","9","542217","622534","1","-80317","17","{""Q0"":""Other"",""Q1"":""Third"",""Q2"":""Social Sciences (incl. CogSci)"",""Q3"":""Female"",""Q4"":""the first one (linear""}","{""Q0"":""20"",""Q1"":""Korea\n""}"
"ObjectId(""58e45df9d46cc6fa347e88fd"")","experiment","foxtrot","3","longmire","axis","5","8","5","10","1","149793","440768","187945","374794","110447","757518","2293758","TPMBF","13","15","590561","562739","2","27822","29","{""Q0"":""English"",""Q1"":""Third"",""Q2"":""Social Sciences (incl. CogSci)"",""Q3"":""Female"",""Q4"":""the first one (linear""}","{""Q0"":""20"",""Q1"":""United States of America""}"
"ObjectId(""58e45df9d46cc6fa347e88fe"")","experiment","foxtrot","2","longmire","axis","4","8","5","9","2","146969","456221","222245","320003","174126","379022","2152293","MJGHF","12","14","603190","542248","2","60942","28","{""Q0"":""Other"",""Q1"":""Fourth"",""Q2"":""Biomedical & Health Sciences"",""Q3"":""Male"",""Q4"":""the second one (triangular)""}","{""Q0"":""21"",""Q1"":""USA""}"
"ObjectId(""58e45df9d46cc6fa347e88ff"")","experiment","foxtrot","3","longmire","axis","4","7","5","9","2","85478","436772","163338","317073","488088","134473","1772431","G1J35","11","14","522250","480411","3","41839","27","{""Q0"":""English"",""Q1"":""Third"",""Q2"":""Social Sciences (incl. CogSci)"",""Q3"":""Female"",""Q4"":""the second one (triangular)""}","{""Q0"":""20"",""Q1"":""usa""}"
"ObjectId(""58e45df9d46cc6fa347e8900"")","experiment","foxtrot","0","longmire","axis","5","7","4","8","0","124722","436649","314353","371009","194184","546082","2150131","GLAFZ","12","12","561371","685362","0","-123991","24","{""Q0"":""Spanish"",""Q1"":""Fourth"",""Q2"":""Social Sciences (incl. CogSci)"",""Q3"":""Female"",""Q4"":""the first one (linear""}","{""Q0"":""21"",""Q1"":""USA""}"
"ObjectId(""58e45df9d46cc6fa347e8901"")","experiment","foxtrot","3","longmire","axis","5","6","4","8","2","127847","387040","235670","336611","721860","195512","2202805","GELJG","11","12","514887","572281","1","-57394","25","{""Q0"":""English"",""Q1"":""Second"",""Q2"":""Biomedical & Health Sciences"",""Q3"":""Female"",""Q4"":""the second one (triangular)""}","{""Q0"":""19"",""Q1"":""United States""}"
"ObjectId(""58e45df9d46cc6fa347e8902"")","experiment","foxtrot","3","longmire","axis","4","6","3","8","1","114659","505671","225099","304412","323366","426035","2474019","848ON","10","11","620330","529511","1","90819","22","{""Q0"":""Spanish"",""Q1"":""Fifth"",""Q2"":""Social Sciences (incl. CogSci)"",""Q3"":""Male"",""Q4"":""the second one (triangular)""}","{""Q0"":""25"",""Q1"":""peru""}"
"ObjectId(""58e45df9d46cc6fa347e8903"")","experiment","foxtrot","0","axis","longmire","1","1","2","2","0","89195","146024","46732","141554","119487","830441","1510910","EBFQN","2","4","235219","188286","2","46933","6","{""Q0"":""English"",""Q1"":""Fourth"",""Q2"":""Social Sciences (incl. CogSci)"",""Q3"":""Female"",""Q4"":""the first one (linear""}","{""Q0"":""21"",""Q1"":""usa""}"
"ObjectId(""58e45df9d46cc6fa347e8904"")","experiment","foxtrot","3","longmire","axis","3","6","1","0","1","156024","663731","520001","722194","170484","487373","3073885","G50Y1","9","1","819755","1242195","-8","-422440","11","{""Q0"":""English"",""Q1"":""Fifth"",""Q2"":""Social Sciences (incl. CogSci)"",""Q3"":""Female"",""Q4"":""the first one (linear""}","{""Q0"":""29"",""Q1"":""USA""}"
"ObjectId(""58e45df9d46cc6fa347e8905"")","experiment","foxtrot","2","longmire","axis","5","5","5","8","1","159871","610422","394891","436450","863269","117880","3123454","B705H","10","13","770293","831341","3","-61048","24","{""Q0"":""Other"",""Q1"":""Fifth"",""Q2"":""Biomedical & Health Sciences"",""Q3"":""Female"",""Q4"":""the second one (triangular)""}","{""Q0"":""23"",""Q1"":""USA""}"
"ObjectId(""58e45df9d46cc6fa347e8906"")","experiment","foxtrot","0","axis","longmire","5","6","5","8","1","133057","266800","147065","446711","175707","579052","2573197","G3HTX","11","13","399857","593776","2","-193919","25","{""Q0"":""Mandarin or Cantonese"",""Q1"":""Second"",""Q2"":""Social Sciences (incl. CogSci)"",""Q3"":""Female"",""Q4"":""the first one (linear""}","{""Q0"":""20"",""Q1"":""cHINA""}"
"ObjectId(""58e45df9d46cc6fa347e8907"")","experiment","foxtrot","0","longmire","axis","5","7","1","1","0","87490","363800","225513","346761","165988","567159","2051062","TAL8M","12","2","451290","572274","-10","-120984","14","{""Q0"":""English"",""Q1"":""Fourth"",""Q2"":""Social Sciences (incl. CogSci)"",""Q3"":""Female"",""Q4"":""the first one (linear""}","{""Q0"":""21"",""Q1"":""United States""}"
"ObjectId(""58e45df9d46cc6fa347e8908"")","experiment","foxtrot","2","axis","longmire","3","5","2","2","0","201411","376202","264009","595786","111108","431639","2669329","OYVRD","8","4","577613","859795","-4","-282182","12","{""Q0"":""English"",""Q1"":""First"",""Q2"":""Social Sciences (incl. CogSci)"",""Q3"":""Female"",""Q4"":""the first one (linear""}","{""Q0"":""19"",""Q1"":""USA""}"
"ObjectId(""58e45df9d46cc6fa347e8909"")","reverse","foxtrot","0","longmire","axis","5","9","4","8","1","138198","442784","266578","410230","420794","51659","1992120","12TUL","14","12","580982","676808","-2","-95826","27","{""Q0"":""English"",""Q1"":""Second"",""Q2"":""Social Sciences (incl. CogSci)"",""Q3"":""Male"",""Q4"":""the second one (triangular)""}","{""Q0"":""19"",""Q1"":""USA""}"
"ObjectId(""58e45df9d46cc6fa347e890a"")","experiment","foxtrot","3","longmire","axis","4","6","0","0","0","104936","344619","137153","295682","356236","91927","1564211","5SOSL","10","0","449555","432835","-10","16720","10","{""Q0"":""Other"",""Q1"":""Third"",""Q2"":""Biomedical & Health Sciences"",""Q3"":""Female"",""Q4"":""the first one (linear""}","{""Q0"":""21"",""Q1"":""Philippines""}"
"ObjectId(""58e45df9d46cc6fa347e890b"")","experiment","foxtrot","0","axis","longmire","4","8","5","9","2","124036","326720","149258","254976","89833","932825","2253576","B2DME","12","14","450756","404234","2","46522","28","{""Q0"":""English"",""Q1"":""Third"",""Q2"":""Social Sciences (incl. CogSci)"",""Q3"":""Female"",""Q4"":""the first one (linear""}","{""Q0"":""21"",""Q1"":""United Kingdom""}"
