"_id","experiment","session","condition","lm_scenarios","tm_scenarios","ls_n","lt_n","ts_n","tt_n","d_n","ls_t","lt_t","ts_t","tt_t","d_t","draw_t","totalTime","subject","linear_score","triangular_score","linear_time","triangular_time","score_diff","time_diff","totalScore","demo1","demo2"
"ObjectId(""58e45d3bd46cc6fa347e72a7"")","reverse","4","0","longmire","axis","4","6","1","3","0","134838","418529","303859","672016","514687","197603","2537333","T42AO","10","4","553367","975875","-6","-422508","14","{""Q0"":""English"",""Q1"":""Third"",""Q2"":""Social Sciences (incl. CogSci)"",""Q3"":""Male"",""Q4"":""the second one (triangular)""}","{""Q0"":""21"",""Q1"":""United States""}"
"ObjectId(""58e45d3bd46cc6fa347e72a8"")","experiment","india","4","axis","longmire","5","8","5","10","1","636112","747207","200547","405701","96924","541249","2899105","SUCUA","13","15","1383319","606248","2","777071","29","{""Q0"":""Other"",""Q1"":""Third"",""Q2"":""Biomedical & Health Sciences"",""Q3"":""Female"",""Q4"":""the first one (linear""}","{""Q0"":""21"",""Q1"":""kENYA""}"
"ObjectId(""58e45d3bd46cc6fa347e72a9"")","experiment","india","2","axis","longmire","2","9","5","9","2","185596","310679","232005","478296","129512","869622","2433601","M8MYD","11","14","496275","710301","3","-214026","27","{""Q0"":""English"",""Q1"":""Second"",""Q2"":""Biomedical & Health Sciences"",""Q3"":""Female"",""Q4"":""the first one (linear""}","{""Q0"":""19"",""Q1"":""USA""}"
"ObjectId(""58e45d3bd46cc6fa347e72aa"")","reverse","india","0","longmire","axis","5","7","5","8","1","100625","401383","165944","549435","123060","737641","2357531","7HDR0","12","13","502008","715379","1","-213371","26","{""Q0"":""English"",""Q1"":""Second"",""Q2"":""Social Sciences (incl. CogSci)"",""Q3"":""Male"",""Q4"":""the second one (triangular)""}","{""Q0"":""19"",""Q1"":""United States""}"
"ObjectId(""58e45d3bd46cc6fa347e72ab"")","experiment","india","0","axis","longmire","4","7","5","8","2","108756","346587","148850","270036","84954","481523","1696135","HZMPX","11","13","455343","418886","2","36457","26","{""Q0"":""English"",""Q1"":""Third"",""Q2"":""Biomedical & Health Sciences"",""Q3"":""Female"",""Q4"":""the first one (linear""}","{""Q0"":""20"",""Q1"":""United States of America""}"
"ObjectId(""58e45d3bd46cc6fa347e72ac"")","experiment","india","4","axis","longmire","3","7","4","9","2","172246","388797","211507","403631","300190","611852","2349180","SPP2M","10","13","561043","615138","3","-54095","25","{""Q0"":""English"",""Q1"":""Second"",""Q2"":""Social Sciences (incl. CogSci)"",""Q3"":""Female"",""Q4"":""the first one (linear""}","{""Q0"":""19"",""Q1"":""USA""}"
"ObjectId(""58e45d3bd46cc6fa347e72ad"")","reverse","india","4","longmire","axis","3","7","3","7","2","131686","350850","266448","415368","115957","725246","2250600","TW6BB","10","10","482536","681816","0","-199280","22","{""Q0"":""English"",""Q1"":""Fourth"",""Q2"":""Humanities"",""Q3"":""Female"",""Q4"":""the second one (triangular)""}","{""Q0"":""22"",""Q1"":""USA""}"
"ObjectId(""58e45d3bd46cc6fa347e72ae"")","experiment","india","4","longmire","axis","5","7","2","8","0","137465","440943","215470","228250","235635","685612","2241066","1BZ30","12","10","578408","443720","-2","134688","22","{""Q0"":""English"",""Q1"":""Third"",""Q2"":""Biomedical & Health Sciences"",""Q3"":""Female"",""Q4"":""the first one (linear""}","{""Q0"":""20"",""Q1"":""United States of America""}"
"ObjectId(""58e45d3bd46cc6fa347e72af"")","experiment","india","0","axis","longmire","5","8","3","7","2","188218","438048","242908","612679","123198","442394","2300970","S3UR3","13","10","626266","855587","-3","-229321","25","{""Q0"":""English"",""Q1"":""First"",""Q2"":""Social Sciences (incl. CogSci)"",""Q3"":""Male"",""Q4"":""the first one (linear""}","{""Q0"":""18"",""Q1"":""United States""}"
"ObjectId(""58e45d3bd46cc6fa347e72b0"")","reverse","india","0","axis","longmire","5","5","2","2","2","172455","455471","202943","465598","138524","466000","2063665","1KNSY","10","4","627926","668541","-6","-40615","16","{""Q0"":""English"",""Q1"":""Fourth"",""Q2"":""Biomedical & Health Sciences"",""Q3"":""Female"",""Q4"":""the first one (linear""}","{""Q0"":""21"",""Q1"":""india""}"
"ObjectId(""58e45d3bd46cc6fa347e72b1"")","reverse","india","4","longmire","axis","4","8","4","10","1","128961","398548","212210","398232","184281","478396","2067321","O0XHK","12","14","527509","610442","2","-82933","27","{""Q0"":""English"",""Q1"":""Third"",""Q2"":""Social Sciences (incl. CogSci)"",""Q3"":""Female"",""Q4"":""the second one (triangular)""}","{""Q0"":""20"",""Q1"":""U.S.""}"
"ObjectId(""58e45d3bd46cc6fa347e72b2"")","experiment","india","3","longmire","axis","3","6","1","8","2","102723","306229","199101","206941","97398","500469","1636360","QVNGE","9","9","408952","406042","0","2910","20","{""Q0"":""Other"",""Q1"":""Third"",""Q2"":""Biomedical & Health Sciences"",""Q3"":""Male"",""Q4"":""the second one (triangular)""}","{""Q0"":""21"",""Q1"":""South Korea""}"
"ObjectId(""58e45d3bd46cc6fa347e72b3"")","experiment","india","4","axis","longmire","4","8","4","8","2","137844","296302","132133","314176","158155","627882","1906739","XEW4X","12","12","434146","446309","0","-12163","26","{""Q0"":""English"",""Q1"":""Third"",""Q2"":""Biomedical & Health Sciences"",""Q3"":""Female"",""Q4"":""the first one (linear""}","{""Q0"":""20"",""Q1"":""USA""}"
"ObjectId(""58e45d3bd46cc6fa347e72b4"")","experiment","india","3","axis","longmire","5","7","4","6","1","155946","409083","193834","648751","154674","495669","2349107","HNVWH","12","10","565029","842585","-2","-277556","23","{""Q0"":""Mandarin or Cantonese"",""Q1"":""Third"",""Q2"":""Math or Computer Sciences"",""Q3"":""Female"",""Q4"":""the first one (linear""}","{""Q0"":""20"",""Q1"":""china""}"
"ObjectId(""58e45d3bd46cc6fa347e72b5"")","experiment","india","3","axis","longmire","4","8","4","8","1","287843","486599","189126","470181","115146","1319787","3173189","55QTL","12","12","774442","659307","0","115135","25","{""Q0"":""Mandarin or Cantonese"",""Q1"":""Second"",""Q2"":""Social Sciences (incl. CogSci)"",""Q3"":""Female"",""Q4"":""the first one (linear""}","{""Q0"":""20"",""Q1"":""China""}"
"ObjectId(""58e45d3bd46cc6fa347e72b6"")","reverse","india","4","axis","longmire","4","7","5","8","1","134890","291658","125992","436999","114439","698398","2070209","JXWJP","11","13","426548","562991","2","-136443","25","{""Q0"":""English"",""Q1"":""Third"",""Q2"":""Social Sciences (incl. CogSci)"",""Q3"":""Female"",""Q4"":""the second one (triangular)""}","{""Q0"":""20"",""Q1"":""USA""}"
"ObjectId(""58e45d3bd46cc6fa347e72b7"")","experiment","india","0","longmire","axis","4","8","1","0","2","92206","417764","446999","399195","120206","387212","2061037","GHT14","12","1","509970","846194","-11","-336224","15","{""Q0"":""Other"",""Q1"":""Fourth"",""Q2"":""Biomedical & Health Sciences"",""Q3"":""Male"",""Q4"":""the first one (linear""}","{""Q0"":""23"",""Q1"":""VIETNAM""}"
"ObjectId(""58e45d3bd46cc6fa347e72b8"")","reverse","india","4","axis","longmire","3","2","1","0","0","178687","230618","121793","248635","14107","631532","1646268","82SJ2","5","1","409305","370428","-4","38877","6","{""Q0"":""English"",""Q1"":""Fourth"",""Q2"":""Social Sciences (incl. CogSci)"",""Q3"":""Male"",""Q4"":""the first one (linear""}","{""Q0"":""24"",""Q1"":""United States""}"
"ObjectId(""58e45d3bd46cc6fa347e72b9"")","reverse","india","4","longmire","axis","4","5","4","6","0","118970","382667","181639","218406","73759","191704","1346061","F8PZP","9","10","501637","400045","1","101592","19","{""Q0"":""Other"",""Q1"":""Third"",""Q2"":""Biomedical & Health Sciences"",""Q3"":""Female"",""Q4"":""the first one (linear""}","{""Q0"":""20"",""Q1"":""Pakistan""}"
"ObjectId(""58e45d3bd46cc6fa347e72ba"")","experiment","india","2","longmire","axis","5","8","4","8","2","139503","424732","129143","236706","77390","462301","1763772","J7RKX","13","12","564235","365849","-1","198386","27","{""Q0"":""English"",""Q1"":""Second"",""Q2"":""Engineering"",""Q3"":""Female"",""Q4"":""the second one (triangular)""}","{""Q0"":""19"",""Q1"":""USA""}"
"ObjectId(""58e45d3bd46cc6fa347e72bb"")","experiment","india","3","axis","longmire","5","8","3","9","1","232370","548430","168997","591422","174582","702513","2786895","XKUQ9","13","12","780800","760419","-1","20381","26","{""Q0"":""English"",""Q1"":""Fourth"",""Q2"":""Social Sciences (incl. CogSci)"",""Q3"":""Female"",""Q4"":""the first one (linear""}","{""Q0"":""24"",""Q1"":""US""}"
"ObjectId(""58e45d3bd46cc6fa347e72bc"")","experiment","india","2","axis","longmire","3","3","1","2","2","118641","196159","105441","287356","339818","83022","1361200","5KVW9","6","3","314800","392797","-3","-77997","11","{""Q0"":""English"",""Q1"":""Fourth"",""Q2"":""Social Sciences (incl. CogSci)"",""Q3"":""Female"",""Q4"":""the first one (linear""}","{""Q0"":""23"",""Q1"":""Canada""}"
"ObjectId(""58e45d3bd46cc6fa347e72bd"")","experiment","india","2","axis","longmire","4","7","4","10","1","198305","278705","110380","256096","141097","331389","1531107","VEL2Z","11","14","477010","366476","3","110534","26","{""Q0"":""English"",""Q1"":""Third"",""Q2"":""Social Sciences (incl. CogSci)"",""Q3"":""Female"",""Q4"":""the second one (triangular)""}","{""Q0"":""21"",""Q1"":""United States""}"
"ObjectId(""58e45d3bd46cc6fa347e72be"")","experiment","india","0","axis","longmire","4","8","4","7","2","91563","223213","112402","311187","354600","22084","1314584","N0V08","12","11","314776","423589","-1","-108813","25","{""Q0"":""Other"",""Q1"":""First"",""Q2"":""Biomedical & Health Sciences"",""Q3"":""Female"",""Q4"":""the second one (triangular)""}","{""Q0"":""18"",""Q1"":""UNITED STATES OF AMERICA""}"
