"_id","experiment","session","condition","lm_scenarios","tm_scenarios","ls_n","lt_n","ts_n","tt_n","d_n","ls_t","lt_t","ts_t","tt_t","d_t","draw_t","totalTime","subject","linear_score","triangular_score","linear_time","triangular_time","score_diff","time_diff","totalScore","demo1","demo2"
"ObjectId(""58e45c5cd46cc6fa347e637b"")","experiment","kilo","1","longmire","axis","5","7","2","8","1","188644","538358","273269","424650","175483","1752394","3647145","WS8KM","12","10","727002","697919","-2","29083","23","{""Q0"":""English"",""Q1"":""Fourth"",""Q2"":""Social Sciences (incl. CogSci)"",""Q3"":""Female"",""Q4"":""the first one (linear""}","{""Q0"":""21"",""Q1"":""United States""}"
"ObjectId(""58e45c5cd46cc6fa347e637c"")","experiment","kilo","1","longmire","axis","5","9","1","1","2","185641","663855","403242","1205815","113099","432754","3344981","41M35","14","2","849496","1609057","-12","-759561","18","{""Q0"":""English"",""Q1"":""Third"",""Q2"":""Social Sciences (incl. CogSci)"",""Q3"":""Female"",""Q4"":""the first one (linear""}","{""Q0"":""21"",""Q1"":""USA""}"
"ObjectId(""58e45c5cd46cc6fa347e637d"")","experiment","kilo","1","longmire","axis","4","5","3","8","1","133223","422789","321157","413589","155423","1328269","3125846","UXLVN","9","11","556012","734746","2","-178734","21","{""Q0"":""English"",""Q1"":""First"",""Q2"":""Social Sciences (incl. CogSci)"",""Q3"":""Female"",""Q4"":""the first one (linear""}","{""Q0"":""19"",""Q1"":""USA""}"
"ObjectId(""58e45c5cd46cc6fa347e637e"")","reverse","kilo","4","longmire","axis","5","4","4","7","2","127910","468169","241545","544601","223633","940562","3002546","4GZS0","9","11","596079","786146","2","-190067","22","{""Q0"":""English"",""Q1"":""Third"",""Q2"":""Social Sciences (incl. CogSci)"",""Q3"":""Female"",""Q4"":""the second one (triangular)""}","{""Q0"":""23"",""Q1"":""United States""}"
"ObjectId(""58e45c5cd46cc6fa347e637f"")","reverse","kilo","1","axis","longmire","5","9","5","9","2","166548","377520","185782","300305","255645","1215357","2846428","TZF8P","14","14","544068","486087","0","57981","30","{""Q0"":""English"",""Q1"":""First"",""Q2"":""Humanities"",""Q3"":""Male"",""Q4"":""the second one (triangular)""}","{""Q0"":""19"",""Q1"":""United States""}"
"ObjectId(""58e45c5cd46cc6fa347e6380"")","experiment","kilo","1","longmire","axis","5","6","3","6","1","126416","336121","227191","278381","146862","546478","2626072","0CDY7","11","9","462537","505572","-2","-43035","21","{""Q0"":""Mandarin or Cantonese"",""Q1"":""Fourth"",""Q2"":""Biomedical & Health Sciences"",""Q3"":""Female"",""Q4"":""the first one (linear""}","{""Q0"":""21"",""Q1"":""China""}"
"ObjectId(""58e45c5cd46cc6fa347e6381"")","experiment","kilo","4","longmire","axis","3","9","5","8","2","193291","495511","226208","354735","191465","837147","2675464","5AW04","12","13","688802","580943","1","107859","27","{""Q0"":""Spanish"",""Q1"":""Fifth"",""Q2"":""Natural Sciences"",""Q3"":""Female"",""Q4"":""the second one (triangular)""}","{""Q0"":""22"",""Q1"":""USA""}"
"ObjectId(""58e45c5cd46cc6fa347e6382"")","experiment","kilo","1","longmire","axis","5","9","3","7","1","180863","478601","291921","298843","208930","782729","2589673","Q3T3X","14","10","659464","590764","-4","68700","25","{""Q0"":""Mandarin or Cantonese"",""Q1"":""Third"",""Q2"":""Social Sciences (incl. CogSci)"",""Q3"":""Female"",""Q4"":""the first one (linear""}","{""Q0"":""20"",""Q1"":""United States of America""}"
"ObjectId(""58e45c5cd46cc6fa347e6383"")","reverse","kilo","4","axis","longmire","4","8","3","9","2","191285","421053","187092","410753","122940","764273","2479884","YNWL4","12","12","612338","597845","0","14493","26","{""Q0"":""Mandarin or Cantonese"",""Q1"":""Second"",""Q2"":""Social Sciences (incl. CogSci)"",""Q3"":""Male"",""Q4"":""the second one (triangular)""}","{""Q0"":""20"",""Q1"":""China""}"
"ObjectId(""58e45c5cd46cc6fa347e6384"")","experiment","kilo","4","axis","longmire","5","7","5","7","2","154085","319859","136542","505005","77657","735756","2243420","45B1U","12","12","473944","641547","0","-167603","26","{""Q0"":""Other"",""Q1"":""Third"",""Q2"":""Math or Computer Sciences"",""Q3"":""Female"",""Q4"":""the first one (linear""}","{""Q0"":""19"",""Q1"":""United Arab Emirates""}"
"ObjectId(""58e45c5cd46cc6fa347e6385"")","reverse","kilo","1","axis","longmire","4","6","2","2","0","162938","243100","184022","389819","143745","917402","2455700","XV5ZB","10","4","406038","573841","-6","-167803","14","{""Q0"":""Spanish"",""Q1"":""Second"",""Q2"":""Fine Arts"",""Q3"":""Female"",""Q4"":""the first one (linear""}","{""Q0"":""19"",""Q1"":""United States of America""}"
"ObjectId(""58e45c5cd46cc6fa347e6386"")","reverse","kilo","1","longmire","axis","4","4","1","0","0","132637","328279","177692","227298","88791","41493","1255624","S0MEG","8","1","460916","404990","-7","55926","9","{""Q0"":""English"",""Q1"":""Third"",""Q2"":""Social Sciences (incl. CogSci)"",""Q3"":""Female"",""Q4"":""the first one (linear""}","{""Q0"":""20"",""Q1"":""US""}"
"ObjectId(""58e45c5cd46cc6fa347e6387"")","experiment","kilo","4","longmire","axis","4","9","4","8","2","150145","369518","161814","386488","120146","719030","2264896","T263H","13","12","519663","548302","-1","-28639","27","{""Q0"":""English"",""Q1"":""First"",""Q2"":""Humanities"",""Q3"":""Female"",""Q4"":""the second one (triangular)""}","{""Q0"":""18"",""Q1"":""U.S.""}"
"ObjectId(""58e45c5cd46cc6fa347e6388"")","experiment","kilo","1","axis","longmire","5","8","4","5","0","178824","396969","216335","805649","111163","808283","2971188","QQDWJ","13","9","575793","1021984","-4","-446191","22","{""Q0"":""English"",""Q1"":""Third"",""Q2"":""Social Sciences (incl. CogSci)"",""Q3"":""Other"",""Q4"":""the first one (linear""}","{""Q0"":""21"",""Q1"":""USA""}"
"ObjectId(""58e45c5cd46cc6fa347e6389"")","reverse","kilo","1","longmire","axis","4","8","0","1","1","125567","386696","214321","312562","171826","785545","2290033","4P4ZR","12","1","512263","526883","-11","-14620","14","{""Q0"":""English"",""Q1"":""Fourth"",""Q2"":""Social Sciences (incl. CogSci)"",""Q3"":""Female"",""Q4"":""the first one (linear""}","{""Q0"":""21"",""Q1"":""United States""}"
"ObjectId(""58e45c5cd46cc6fa347e638a"")","reverse","kilo","1","longmire","axis","4","7","4","5","1","139217","507482","231132","311977","156390","431875","2200341","N7XN2","11","9","646699","543109","-2","103590","21","{""Q0"":""English"",""Q1"":""Fourth"",""Q2"":""Biomedical & Health Sciences"",""Q3"":""Female"",""Q4"":""the second one (triangular)""}","{""Q0"":""21"",""Q1"":""US""}"
"ObjectId(""58e45c5cd46cc6fa347e638b"")","reverse","kilo","1","axis","longmire","4","6","5","9","2","141417","270184","143488","408931","115266","625665","2057688","13P8A","10","14","411601","552419","4","-140818","26","{""Q0"":""English"",""Q1"":""First"",""Q2"":""Social Sciences (incl. CogSci)"",""Q3"":""Female"",""Q4"":""the first one (linear""}","{""Q0"":""19"",""Q1"":""United States""}"
"ObjectId(""58e45c5cd46cc6fa347e638c"")","experiment","kilo","4","longmire","axis","4","9","5","8","2","157513","531920","200192","388854","182757","1495642","3190358","G56GO","13","13","689433","589046","0","100387","28","{""Q0"":""English"",""Q1"":""First"",""Q2"":""Social Sciences (incl. CogSci)"",""Q3"":""Female"",""Q4"":""the second one (triangular)""}","{""Q0"":""18"",""Q1"":""United States""}"
"ObjectId(""58e45c5cd46cc6fa347e638d"")","experiment","kilo","4","axis","longmire","3","5","2","9","0","155720","371870","138626","490572","197278","538755","2185049","CMXGY","8","11","527590","629198","3","-101608","19","{""Q0"":""Spanish"",""Q1"":""Third"",""Q2"":""Social Sciences (incl. CogSci)"",""Q3"":""Female"",""Q4"":""the first one (linear""}","{""Q0"":""21"",""Q1"":""US""}"
"ObjectId(""58e45c5cd46cc6fa347e638e"")","experiment","kilo","1","longmire","axis","5","6","5","6","1","139589","459197","195076","405041","111210","765351","2377095","YJN84","11","11","598786","600117","0","-1331","23","{""Q0"":""Mandarin or Cantonese"",""Q1"":""First"",""Q2"":""Natural Sciences"",""Q3"":""Female"",""Q4"":""the first one (linear""}","{""Q0"":""18"",""Q1"":""Canada""}"
"ObjectId(""58e45c5cd46cc6fa347e638f"")","reverse","kilo","4","longmire","axis","5","8","3","9","2","98211","378950","158948","289614","137147","502802","1883856","4S72Y","13","12","477161","448562","-1","28599","27","{""Q0"":""English"",""Q1"":""First"",""Q2"":""Social Sciences (incl. CogSci)"",""Q3"":""Female"",""Q4"":""the second one (triangular)""}","{""Q0"":""18"",""Q1"":""United States of America""}"
"ObjectId(""58e45c5cd46cc6fa347e6390"")","experiment","kilo","1","longmire","axis","4","9","1","0","1","116961","303409","237318","320048","131706","758173","2164700","83WD2","13","1","420370","557366","-12","-136996","15","{""Q0"":""Mandarin or Cantonese"",""Q1"":""Third"",""Q2"":""Biomedical & Health Sciences"",""Q3"":""Female"",""Q4"":""the first one (linear""}","{""Q0"":""21"",""Q1"":""Hong Kong""}"
"ObjectId(""58e45c5cd46cc6fa347e6391"")","reverse","kilo","1","axis","longmire","4","5","5","8","2","139800","335541","139346","403998","209894","620815","2151051","V37VJ","9","13","475341","543344","4","-68003","24","{""Q0"":""Other"",""Q1"":""First"",""Q2"":""Social Sciences (incl. CogSci)"",""Q3"":""Male"",""Q4"":""the second one (triangular)""}","{""Q0"":""19"",""Q1"":""South Korea""}"
"ObjectId(""58e45c5cd46cc6fa347e6392"")","reverse","kilo","1","longmire","axis","5","7","4","7","1","117052","447765","196095","280265","152519","531376","2100668","XX3HL","12","11","564817","476360","-1","88457","24","{""Q0"":""Spanish"",""Q1"":""Second"",""Q2"":""Engineering"",""Q3"":""Male"",""Q4"":""the second one (triangular)""}","{""Q0"":""20"",""Q1"":""United States""}"
"ObjectId(""58e45c5cd46cc6fa347e6393"")","reverse","kilo","1","longmire","axis","4","5","1","0","2","78280","288559","357386","397239","106537","491972","2000882","GQ13P","9","1","366839","754625","-8","-387786","12","{""Q0"":""English"",""Q1"":""First"",""Q2"":""Fine Arts"",""Q3"":""Female"",""Q4"":""the first one (linear""}","{""Q0"":""19"",""Q1"":""United States""}"
"ObjectId(""58e45c5cd46cc6fa347e6394"")","experiment","kilo","4","longmire","axis","4","9","3","7","0","132766","337178","144264","388913","164748","111306","1625400","7UDVY","13","10","469944","533177","-3","-63233","23","{""Q0"":""English"",""Q1"":""Fourth"",""Q2"":""Social Sciences (incl. CogSci)"",""Q3"":""Female"",""Q4"":""the second one (triangular)""}","{""Q0"":""22"",""Q1"":""USA""}"
"ObjectId(""58e45c5cd46cc6fa347e6395"")","experiment","kilo","1","axis","longmire","4","6","4","9","1","327089","543862","335159","473570","817854","121913","3146162","R70BB","10","13","870951","808729","3","62222","24","{""Q0"":""Mandarin or Cantonese"",""Q1"":""First"",""Q2"":""Natural Sciences"",""Q3"":""Male"",""Q4"":""the second one (triangular)""}","{""Q0"":""19"",""Q1"":""China""}"
"ObjectId(""58e45c5cd46cc6fa347e6396"")","experiment","kilo","1","longmire","axis","4","6","0","8","2","105831","258747","251368","389793","142568","456845","1983799","220F7","10","8","364578","641161","-2","-276583","20","{""Q0"":""Spanish"",""Q1"":""First"",""Q2"":""Humanities"",""Q3"":""Female"",""Q4"":""the first one (linear""}","{""Q0"":""18"",""Q1"":""United States""}"
